Report Month,Department,0 Days,1 Day,2 Days,3 Days,4 Days,5 Days,Total
2021-10,0500 - Governor's Office,39,17,13,19,3,12,103
2021-10,0509 - Governor's Office of Business and Economic Development (GO-Biz),92,17,5,5,5,1,125
2021-10,0511 - Secretary for Government Operations Agency,19,1,3,1,0,0,24
2021-10,"0515 - Secretary for Business, Consumer Services, and Housing Agency",32,10,3,1,0,1,47
2021-10,0521 - Secretary for Transportation Agency,0,19,0,2,0,1,22
2021-10,0531 - Office of Systems Integration,302,29,2,0,1,1,335
2021-10,0540 - Secretary of the Natural Resources Agency,76,1,1,8,0,0,86
2021-10,0552 - Office of the Inspector General,96,17,1,3,2,11,130
2021-10,0555 - Secretary for Environmental Protection,59,2,4,0,0,5,70
2021-10,0559 - Secretary for Labor and Workforce Development Agency,3,3,8,8,2,4,28
2021-10,0650 - Office of Planning and Research,86,5,9,10,2,0,112
2021-10,0690 - Governor's Office of Emergency Services,492,121,131,107,68,129,1048
2021-10,0820 - Department of Justice,1620,538,511,528,321,359,3877
2021-10,0855 - California Gambling Control Commission,23,9,3,2,0,0,37
2021-10,0860 - State Board of Equalization,148,0,0,6,0,0,154
2021-10,0890 - Secretary of State,101,0,392,40,22,8,563
2021-10,1045 - Cannabis Control Appeals Panel,5,1,0,1,1,0,8
2021-10,1111 - Department of Consumer Affairs,644,514,492,309,251,294,2504
2021-10,1115 - Department of Cannabis Control,242,20,36,12,1,68,379
2021-10,1700 - California Civil Rights Department,197,37,18,3,2,5,262
2021-10,1701 - Department of Financial Protection and Innovation,541,27,37,35,2,6,648
2021-10,1703 - California Privacy Protection Agency,1,0,0,0,0,1,2
2021-10,1750 - California Horse Racing Board,12,2,9,1,4,1,29
2021-10,2100 - Department of Alcoholic Beverage Control,45,33,98,154,98,24,452
2021-10,2120 - Alcoholic Beverage Control Appeals Board,2,1,2,1,0,0,6
2021-10,2240 - Department of Housing and Community Development,495,65,78,73,9,86,806
2021-10,2320 - Department of Real Estate,22,121,136,18,24,7,328
2021-10,2600 - California Transportation Commission,20,10,4,0,0,0,34
2021-10,2665 - High-Speed Rail Authority,162,37,41,26,17,8,291
2021-10,2720 - California Highway Patrol,0,157,0,329,0,1010,1496
2021-10,3105 - California African-American Museum,0,0,0,18,0,0,18
2021-10,3125 - California Tahoe Conservancy,41,0,0,0,0,1,42
2021-10,3340 - California Conservation Corps,0,91,9,49,0,0,149
2021-10,3355 - Office of Energy Infrastructure Safety,26,0,0,0,0,0,26
2021-10,3360 - Energy Resources Conservation and Development Commission,525,43,18,9,3,0,598
2021-10,3480 - Department of Conservation,325,88,89,58,21,35,616
2021-10,3540 - Department of Forestry and Fire Protection,61,37,30,20,7,4,159
2021-10,3560 - State Lands Commission,114,14,25,5,6,2,166
2021-10,3600 - Department of Fish and Wildlife,819,111,154,52,21,665,1822
2021-10,3640 - Wildlife Conservation Board,14,0,1,1,0,16,32
2021-10,3720 - California Coastal Commission,0,178,0,0,0,0,178
2021-10,3760 - State Coastal Conservancy,41,8,3,1,0,0,53
2021-10,3780 - Native American Heritage Commission,7,0,0,1,0,0,8
2021-10,3790 - Department of Parks and Recreation,349,98,103,173,118,321,1162
2021-10,3810 - Santa Monica Mountains Conservancy,7,0,0,0,0,0,7
2021-10,3820 - San Francisco Bay Conservation and Development Commission,48,0,0,0,0,0,48
2021-10,3825 - San Gabriel and Lower Los Angeles Rivers and Mountains Conservancy,0,3,5,0,0,0,8
2021-10,3830 - San Joaquin River Conservancy,2,1,0,0,0,0,3
2021-10,3835 - Baldwin Hills Conservancy,2,0,1,0,0,0,3
2021-10,3840 - Delta Protection Commission,2,2,0,0,1,0,5
2021-10,3845 - San Diego River Conservancy,0,0,0,0,0,3,3
2021-10,3850 - Coachella Valley Mountains Conservancy,0,0,1,1,2,0,4
2021-10,3855 - Sierra Nevada Conservancy,25,6,1,3,0,0,35
2021-10,3860 - Department of Water Resources,582,649,427,339,171,0,2168
2021-10,3862 - Central Valley Flood Protection Board,38,3,6,0,1,0,48
2021-10,3875 - Sacramento-San Joaquin Delta Conservancy,10,1,0,0,0,0,11
2021-10,3885 - Delta Stewardship Council,40,8,5,0,1,0,54
2021-10,3900 - State Air Resources Board,1223,184,92,63,46,24,1632
2021-10,3930 - Department of Pesticide Regulation,219,94,55,24,11,7,410
2021-10,3940 - State Water Resources Control Board,1673,118,74,73,16,268,2222
2021-10,3960 - Department of Toxic Substances Control,428,149,86,63,33,204,963
2021-10,3970 - Department of Resources Recycling and Recovery,464,104,84,28,21,63,764
2021-10,4100 - State Council on Developmental Disabilities,30,6,13,6,6,5,66
2021-10,4140 - Department of Health Care Access and Information,344,44,13,19,11,9,440
2021-10,4150 - Department of Managed Health Care,489,4,2,0,0,0,495
2021-10,4170 - Department of Aging,175,0,2,3,3,0,183
2021-10,4250 - California Children and Families Commission,0,0,13,0,0,0,13
2021-10,4265 - Department of Public Health,2456,137,112,83,24,1126,3938
2021-10,4300 - Department of Developmental Services,374,87,43,30,7,23,564
2021-10,4440 - Department of State Hospitals,269,272,77,183,121,51,973
2021-10,4700 - Department of Community Services and Development,103,3,0,1,0,1,108
2021-10,4800 - California Health Benefit Exchange,1257,3,13,29,4,19,1325
2021-10,5160 - Department of Rehabilitation,273,225,496,454,77,121,1646
2021-10,5175 - Department of Child Support Services,471,56,16,11,15,0,569
2021-10,5180 - Department of Social Services,2285,487,614,1377,388,0,5151
2021-10,5225 - Department of Corrections and Rehabilitation,1342,573,430,571,251,1370,4537
2021-10,5227 - Board of State and Community Corrections,94,2,1,1,2,0,100
2021-10,5420 - Prison Industry Authority,6,0,3,7,7,0,23
2021-10,6120 - California State Library,47,17,13,32,29,3,141
2021-10,6125 - Education Audit Appeals Panel,0,2,1,0,0,0,3
2021-10,6250 - California School for the Deaf - Riverside,0,2,1,10,0,6,19
2021-10,6360 - Commission on Teacher Credentialing,80,37,16,4,4,1,142
2021-10,6870 - Board of Governors of the California Community Colleges,162,1,4,1,0,0,168
2021-10,"6980 - Student Aid Commission, California",138,0,0,0,0,0,138
2021-10,7100 - Employment Development Department,985,168,281,207,26,27,1694
2021-10,7300 - Agricultural Labor Relations Board,13,7,34,4,1,4,63
2021-10,7320 - Public Employment Relations Board,21,26,14,4,3,1,69
2021-10,7501 - Department of Human Resources,213,36,21,13,4,8,295
2021-10,7502 - California Department of Technology,718,42,34,7,7,78,886
2021-10,7503 - State Personnel Board,51,18,8,0,0,0,77
2021-10,7504 - Office of Data and Innovation,17,0,0,0,0,0,17
2021-10,7600 - California Department of Tax and Fee Administration,2477,521,329,114,12,21,3474
2021-10,7730 - Franchise Tax Board,2785,581,95,91,44,1514,5110
2021-10,7760 - Department of General Services,1167,192,94,88,74,371,1986
2021-10,7870 - California Victim Compensation Board,220,0,0,0,0,3,223
2021-10,7910 - Office of Administrative Law,0,9,4,5,3,0,21
2021-10,7920 - State Teachers' Retirement System,1286,2,2,0,0,0,1290
2021-10,8120 - Commission on Peace Officer Standards and Training,0,0,128,3,1,3,135
2021-10,8140 - State Public Defender,46,4,7,13,2,8,80
2021-10,8560 - California Exposition and State Fair,0,1,0,1,0,0,2
2021-10,8570 - Department of Food and Agriculture,177,69,91,57,23,65,482
2021-10,8620 - Fair Political Practices Commission,77,2,0,0,0,1,80
2021-10,8660 - Public Utilities Commission,324,710,137,55,13,1,1240
2021-10,"8780 - Milton Marks ""Little Hoover"" Commission on California State Government Organization and Economy",7,0,0,0,0,0,7
2021-10,8825 - Commission on Asian and Pacific Islander American Affairs,1,0,0,0,0,0,1
2021-10,"8830 - Law Revision Commission, California",7,0,0,0,0,0,7
2021-10,8860 - Department of Finance,186,96,36,32,13,10,373
2021-10,8880 - Financial Information System for California,257,11,6,3,1,0,278
2021-10,"8885 - States Mandates, Commission on",1,9,0,1,0,0,11
2021-10,8940 - Military Department,10,5,3,15,5,0,38
2021-10,8955 - Department of Veterans Affairs,189,49,107,45,26,14,430
2021-10,A059 - California Correctional Health Care Services,705,251,456,451,163,157,2183
2021-10,A314 - California Science Center,2,0,0,26,2,2,32
2021-10,A341 - California Earthquake Authority,75,2,3,2,0,1,83
2021-10,A424 - Cradle-to-Career,1,0,0,0,0,0,1
2021-10,A541 - Board of Forestry and Fire Protection,0,1,0,0,0,0,1
2021-11,0500 - Governor's Office,36,19,15,17,6,13,106
2021-11,0509 - Governor's Office of Business and Economic Development (GO-Biz),91,20,7,5,3,1,127
2021-11,0511 - Secretary for Government Operations Agency,19,1,3,1,0,0,24
2021-11,"0515 - Secretary for Business, Consumer Services, and Housing Agency",31,10,3,1,0,1,46
2021-11,0521 - Secretary for Transportation Agency,0,19,0,2,0,1,22
2021-11,0531 - Office of Systems Integration,267,61,7,0,1,1,337
2021-11,0540 - Secretary of the Natural Resources Agency,78,0,1,8,0,0,87
2021-11,0552 - Office of the Inspector General,103,11,0,2,2,12,130
2021-11,0555 - Secretary for Environmental Protection,57,2,4,0,0,4,67
2021-11,0559 - Secretary for Labor and Workforce Development Agency,3,3,8,8,2,4,28
2021-11,0650 - Office of Planning and Research,86,5,9,10,2,0,112
2021-11,0690 - Governor's Office of Emergency Services,502,110,140,119,61,121,1053
2021-11,0820 - Department of Justice,1620,538,511,528,321,359,3877
2021-11,0855 - California Gambling Control Commission,23,9,3,2,0,0,37
2021-11,0860 - State Board of Equalization,151,0,0,7,0,0,158
2021-11,0890 - Secretary of State,101,0,392,40,22,8,563
2021-11,1045 - Cannabis Control Appeals Panel,5,1,0,1,1,0,8
2021-11,1111 - Department of Consumer Affairs,645,498,502,310,257,312,2524
2021-11,1115 - Department of Cannabis Control,251,20,37,12,1,67,388
2021-11,1700 - California Civil Rights Department,197,37,18,3,2,5,262
2021-11,1701 - Department of Financial Protection and Innovation,548,27,38,33,2,10,658
2021-11,1703 - California Privacy Protection Agency,1,0,0,0,0,1,2
2021-11,1750 - California Horse Racing Board,12,2,9,1,4,1,29
2021-11,2100 - Department of Alcoholic Beverage Control,45,33,94,153,101,22,448
2021-11,2120 - Alcoholic Beverage Control Appeals Board,2,1,2,1,0,0,6
2021-11,2240 - Department of Housing and Community Development,506,67,80,74,9,87,823
2021-11,2320 - Department of Real Estate,22,121,136,18,24,7,328
2021-11,2600 - California Transportation Commission,20,10,4,0,0,0,34
2021-11,2665 - High-Speed Rail Authority,172,29,48,22,13,10,294
2021-11,2720 - California Highway Patrol,0,157,0,336,0,1010,1503
2021-11,3105 - California African-American Museum,0,0,0,18,0,0,18
2021-11,3125 - California Tahoe Conservancy,41,0,0,0,0,1,42
2021-11,3340 - California Conservation Corps,0,90,9,49,0,0,148
2021-11,3355 - Office of Energy Infrastructure Safety,30,0,0,0,0,0,30
2021-11,3360 - Energy Resources Conservation and Development Commission,525,43,18,9,3,0,598
2021-11,3480 - Department of Conservation,327,88,89,58,21,35,618
2021-11,3540 - Department of Forestry and Fire Protection,67,43,36,20,11,4,181
2021-11,3560 - State Lands Commission,113,14,27,5,6,2,167
2021-11,3600 - Department of Fish and Wildlife,819,111,154,52,21,665,1822
2021-11,3640 - Wildlife Conservation Board,14,0,1,1,0,16,32
2021-11,3720 - California Coastal Commission,0,178,0,0,0,0,178
2021-11,3760 - State Coastal Conservancy,41,8,3,2,0,0,54
2021-11,3780 - Native American Heritage Commission,7,0,0,1,0,0,8
2021-11,3790 - Department of Parks and Recreation,349,99,104,173,114,323,1162
2021-11,3810 - Santa Monica Mountains Conservancy,7,0,0,0,0,0,7
2021-11,3820 - San Francisco Bay Conservation and Development Commission,48,0,0,0,0,0,48
2021-11,3825 - San Gabriel and Lower Los Angeles Rivers and Mountains Conservancy,0,6,3,0,0,0,9
2021-11,3830 - San Joaquin River Conservancy,2,1,0,0,0,0,3
2021-11,3835 - Baldwin Hills Conservancy,2,1,0,0,0,0,3
2021-11,3840 - Delta Protection Commission,2,2,0,0,1,0,5
2021-11,3845 - San Diego River Conservancy,0,0,0,0,0,3,3
2021-11,3850 - Coachella Valley Mountains Conservancy,0,0,1,1,2,0,4
2021-11,3855 - Sierra Nevada Conservancy,28,6,2,3,0,0,39
2021-11,3860 - Department of Water Resources,272,774,494,392,254,0,2186
2021-11,3862 - Central Valley Flood Protection Board,38,3,12,0,1,0,54
2021-11,3875 - Sacramento-San Joaquin Delta Conservancy,10,1,0,0,0,0,11
2021-11,3885 - Delta Stewardship Council,41,8,5,0,1,0,55
2021-11,3900 - State Air Resources Board,1212,175,107,63,48,27,1632
2021-11,3930 - Department of Pesticide Regulation,219,90,64,21,11,6,411
2021-11,3940 - State Water Resources Control Board,1698,119,76,76,16,278,2263
2021-11,3960 - Department of Toxic Substances Control,59,387,165,62,54,239,966
2021-11,3970 - Department of Resources Recycling and Recovery,470,108,79,32,22,53,764
2021-11,4100 - State Council on Developmental Disabilities,30,6,13,6,6,5,66
2021-11,4140 - Department of Health Care Access and Information,331,49,14,26,11,10,441
2021-11,4150 - Department of Managed Health Care,488,4,2,0,0,0,494
2021-11,4170 - Department of Aging,174,0,2,3,3,0,182
2021-11,4250 - California Children and Families Commission,0,0,13,0,0,0,13
2021-11,4265 - Department of Public Health,2456,137,112,83,24,1126,3938
2021-11,4300 - Department of Developmental Services,372,87,39,34,6,26,564
2021-11,4440 - Department of State Hospitals,276,274,73,187,129,45,984
2021-11,4700 - Department of Community Services and Development,104,3,0,1,0,1,109
2021-11,4800 - California Health Benefit Exchange,1264,3,15,28,4,17,1331
2021-11,5160 - Department of Rehabilitation,269,228,491,443,93,128,1652
2021-11,5175 - Department of Child Support Services,469,56,17,11,15,0,568
2021-11,5180 - Department of Social Services,2285,487,614,1377,388,0,5151
2021-11,5225 - Department of Corrections and Rehabilitation,1342,573,430,571,251,1370,4537
2021-11,5227 - Board of State and Community Corrections,95,1,0,1,3,0,100
2021-11,5420 - Prison Industry Authority,15,34,47,29,8,0,133
2021-11,6120 - California State Library,49,19,11,32,29,3,143
2021-11,6125 - Education Audit Appeals Panel,0,2,1,0,0,0,3
2021-11,6250 - California School for the Deaf - Riverside,0,2,1,10,0,6,19
2021-11,6360 - Commission on Teacher Credentialing,81,36,17,5,4,2,145
2021-11,6870 - Board of Governors of the California Community Colleges,164,1,4,1,0,0,170
2021-11,"6980 - Student Aid Commission, California",138,0,0,0,0,0,138
2021-11,7100 - Employment Development Department,988,168,285,207,26,26,1700
2021-11,7300 - Agricultural Labor Relations Board,14,7,33,4,1,3,62
2021-11,7320 - Public Employment Relations Board,21,26,15,5,4,1,72
2021-11,7501 - Department of Human Resources,217,35,21,12,3,9,297
2021-11,7502 - California Department of Technology,704,44,24,9,3,101,885
2021-11,7503 - State Personnel Board,54,17,3,2,1,0,77
2021-11,7504 - Office of Data and Innovation,17,0,0,0,0,0,17
2021-11,7600 - California Department of Tax and Fee Administration,2477,521,329,114,12,21,3474
2021-11,7730 - Franchise Tax Board,2784,580,95,91,44,1514,5108
2021-11,7760 - Department of General Services,1154,187,96,81,72,372,1962
2021-11,7870 - California Victim Compensation Board,222,0,0,0,0,3,225
2021-11,7910 - Office of Administrative Law,0,9,4,5,3,0,21
2021-11,7920 - State Teachers' Retirement System,1283,1,2,0,0,0,1286
2021-11,8120 - Commission on Peace Officer Standards and Training,0,1,123,3,3,3,133
2021-11,8140 - State Public Defender,48,5,7,13,2,8,83
2021-11,8560 - California Exposition and State Fair,0,1,0,1,0,0,2
2021-11,8570 - Department of Food and Agriculture,171,70,70,60,22,64,457
2021-11,8620 - Fair Political Practices Commission,78,2,0,0,0,1,81
2021-11,8660 - Public Utilities Commission,327,702,139,55,13,0,1236
2021-11,"8780 - Milton Marks ""Little Hoover"" Commission on California State Government Organization and Economy",7,0,0,0,0,0,7
2021-11,8825 - Commission on Asian and Pacific Islander American Affairs,1,0,0,0,0,0,1
2021-11,"8830 - Law Revision Commission, California",7,0,0,0,0,0,7
2021-11,8860 - Department of Finance,191,96,36,32,13,10,378
2021-11,8880 - Financial Information System for California,266,10,6,3,0,0,285
2021-11,"8885 - States Mandates, Commission on",1,9,0,1,0,0,11
2021-11,8940 - Military Department,10,5,3,15,5,0,38
2021-11,8955 - Department of Veterans Affairs,189,49,107,45,26,14,430
2021-11,A059 - California Correctional Health Care Services,726,261,466,457,169,159,2238
2021-11,A314 - California Science Center,2,0,0,26,2,2,32
2021-11,A341 - California Earthquake Authority,75,2,4,2,0,1,84
2021-11,A424 - Cradle-to-Career,2,0,1,0,0,0,3
2021-11,A541 - Board of Forestry and Fire Protection,0,1,0,0,0,0,1
2021-12,0500 - Governor's Office,38,23,16,15,7,11,110
2021-12,0509 - Governor's Office of Business and Economic Development (GO-Biz),95,16,7,5,2,1,126
2021-12,0511 - Secretary for Government Operations Agency,23,1,5,0,0,0,29
2021-12,"0515 - Secretary for Business, Consumer Services, and Housing Agency",35,11,3,2,0,1,52
2021-12,0521 - Secretary for Transportation Agency,0,19,0,2,0,1,22
2021-12,0531 - Office of Systems Integration,297,33,5,0,2,0,337
2021-12,0540 - Secretary of the Natural Resources Agency,78,0,1,8,0,0,87
2021-12,0552 - Office of the Inspector General,108,7,0,4,3,11,133
2021-12,0555 - Secretary for Environmental Protection,58,2,4,0,0,4,68
2021-12,0559 - Secretary for Labor and Workforce Development Agency,3,3,8,8,2,4,28
2021-12,0650 - Office of Planning and Research,86,5,9,10,2,0,112
2021-12,0690 - Governor's Office of Emergency Services,520,106,132,113,76,114,1061
2021-12,0820 - Department of Justice,1620,538,511,528,321,359,3877
2021-12,0855 - California Gambling Control Commission,23,9,4,1,0,0,37
2021-12,0860 - State Board of Equalization,152,0,0,7,0,0,159
2021-12,0890 - Secretary of State,101,0,392,40,22,8,563
2021-12,1045 - Cannabis Control Appeals Panel,5,1,0,1,1,0,8
2021-12,1111 - Department of Consumer Affairs,633,501,509,315,269,297,2524
2021-12,1115 - Department of Cannabis Control,249,20,39,13,1,69,391
2021-12,1700 - California Civil Rights Department,197,37,18,3,2,5,262
2021-12,1701 - Department of Financial Protection and Innovation,558,26,37,34,2,10,667
2021-12,1703 - California Privacy Protection Agency,2,0,0,0,0,1,3
2021-12,1750 - California Horse Racing Board,12,2,9,1,4,1,29
2021-12,2100 - Department of Alcoholic Beverage Control,45,34,93,158,95,25,450
2021-12,2120 - Alcoholic Beverage Control Appeals Board,2,1,2,1,0,0,6
2021-12,2240 - Department of Housing and Community Development,513,67,80,74,9,87,830
2021-12,2320 - Department of Real Estate,22,121,136,18,24,7,328
2021-12,2600 - California Transportation Commission,22,10,4,0,0,0,36
2021-12,2665 - High-Speed Rail Authority,172,29,47,28,12,10,298
2021-12,2720 - California Highway Patrol,0,154,0,332,0,1009,1495
2021-12,3105 - California African-American Museum,0,0,0,18,0,0,18
2021-12,3125 - California Tahoe Conservancy,41,0,0,0,0,1,42
2021-12,3340 - California Conservation Corps,0,91,9,50,0,0,150
2021-12,3355 - Office of Energy Infrastructure Safety,30,0,0,0,0,0,30
2021-12,3360 - Energy Resources Conservation and Development Commission,525,43,18,9,3,0,598
2021-12,3480 - Department of Conservation,329,88,89,58,21,34,619
2021-12,3540 - Department of Forestry and Fire Protection,67,45,38,26,12,4,192
2021-12,3560 - State Lands Commission,113,14,29,5,6,2,169
2021-12,3600 - Department of Fish and Wildlife,819,111,154,52,21,665,1822
2021-12,3640 - Wildlife Conservation Board,14,0,1,1,0,16,32
2021-12,3720 - California Coastal Commission,0,178,0,0,0,0,178
2021-12,3760 - State Coastal Conservancy,41,8,3,2,0,0,54
2021-12,3780 - Native American Heritage Commission,7,0,0,1,0,0,8
2021-12,3790 - Department of Parks and Recreation,354,109,117,195,124,272,1171
2021-12,3810 - Santa Monica Mountains Conservancy,7,0,0,0,0,0,7
2021-12,3820 - San Francisco Bay Conservation and Development Commission,48,0,0,0,0,0,48
2021-12,3825 - San Gabriel and Lower Los Angeles Rivers and Mountains Conservancy,1,6,2,0,0,0,9
2021-12,3830 - San Joaquin River Conservancy,2,1,0,0,0,0,3
2021-12,3835 - Baldwin Hills Conservancy,2,1,0,0,0,0,3
2021-12,3840 - Delta Protection Commission,2,2,0,0,1,0,5
2021-12,3845 - San Diego River Conservancy,0,0,0,0,0,3,3
2021-12,3850 - Coachella Valley Mountains Conservancy,0,0,1,1,2,0,4
2021-12,3855 - Sierra Nevada Conservancy,29,7,1,3,0,0,40
2021-12,3860 - Department of Water Resources,542,663,473,298,229,23,2228
2021-12,3862 - Central Valley Flood Protection Board,38,3,12,0,1,0,54
2021-12,3875 - Sacramento-San Joaquin Delta Conservancy,10,1,0,0,0,0,11
2021-12,3885 - Delta Stewardship Council,41,8,5,0,1,0,55
2021-12,3900 - State Air Resources Board,463,543,369,93,73,13,1554
2021-12,3930 - Department of Pesticide Regulation,214,101,66,19,14,7,421
2021-12,3940 - State Water Resources Control Board,1722,121,79,81,16,296,2315
2021-12,3960 - Department of Toxic Substances Control,313,146,130,78,23,290,980
2021-12,3970 - Department of Resources Recycling and Recovery,490,117,68,22,23,44,764
2021-12,4100 - State Council on Developmental Disabilities,30,6,13,6,6,5,66
2021-12,4140 - Department of Health Care Access and Information,334,47,14,26,11,10,442
2021-12,4150 - Department of Managed Health Care,483,4,2,0,0,0,489
2021-12,4170 - Department of Aging,173,3,4,6,3,1,190
2021-12,4250 - California Children and Families Commission,0,0,13,0,0,0,13
2021-12,4265 - Department of Public Health,2456,137,112,83,24,1126,3938
2021-12,4300 - Department of Developmental Services,369,86,41,31,5,27,559
2021-12,4440 - Department of State Hospitals,282,263,73,186,133,43,980
2021-12,4700 - Department of Community Services and Development,103,3,0,1,0,1,108
2021-12,4800 - California Health Benefit Exchange,1264,3,11,24,3,18,1323
2021-12,5160 - Department of Rehabilitation,270,221,491,436,92,124,1634
2021-12,5175 - Department of Child Support Services,473,58,17,11,15,0,574
2021-12,5180 - Department of Social Services,2285,487,614,1377,388,0,5151
2021-12,5225 - Department of Corrections and Rehabilitation,1341,573,429,571,251,1369,4534
2021-12,5227 - Board of State and Community Corrections,95,1,0,0,3,0,99
2021-12,5420 - Prison Industry Authority,17,34,88,38,8,1,186
2021-12,6120 - California State Library,51,18,12,32,29,3,145
2021-12,6125 - Education Audit Appeals Panel,0,2,1,0,0,0,3
2021-12,6250 - California School for the Deaf - Riverside,0,2,1,10,0,6,19
2021-12,6360 - Commission on Teacher Credentialing,82,36,16,5,4,2,145
2021-12,6870 - Board of Governors of the California Community Colleges,163,1,4,1,0,0,169
2021-12,"6980 - Student Aid Commission, California",138,0,0,0,0,0,138
2021-12,7100 - Employment Development Department,983,168,273,209,26,26,1685
2021-12,7300 - Agricultural Labor Relations Board,14,7,33,4,1,3,62
2021-12,7320 - Public Employment Relations Board,21,26,17,4,4,1,73
2021-12,7501 - Department of Human Resources,214,37,22,10,6,7,296
2021-12,7502 - California Department of Technology,718,42,34,7,7,78,886
2021-12,7503 - State Personnel Board,53,17,4,2,0,0,76
2021-12,7504 - Office of Data and Innovation,19,0,0,0,0,0,19
2021-12,7600 - California Department of Tax and Fee Administration,2477,521,329,114,12,21,3474
2021-12,7730 - Franchise Tax Board,2733,552,84,78,44,1609,5100
2021-12,7760 - Department of General Services,1139,185,95,83,72,387,1961
2021-12,7870 - California Victim Compensation Board,223,0,0,0,0,2,225
2021-12,7910 - Office of Administrative Law,0,9,4,5,3,0,21
2021-12,7920 - State Teachers' Retirement System,1291,2,2,0,0,0,1295
2021-12,8120 - Commission on Peace Officer Standards and Training,0,1,126,3,2,2,134
2021-12,8140 - State Public Defender,47,5,7,13,2,9,83
2021-12,8560 - California Exposition and State Fair,0,1,0,1,0,0,2
2021-12,8570 - Department of Food and Agriculture,187,72,70,61,19,58,467
2021-12,8620 - Fair Political Practices Commission,79,2,0,0,0,1,82
2021-12,8660 - Public Utilities Commission,330,701,139,55,13,0,1238
2021-12,"8780 - Milton Marks ""Little Hoover"" Commission on California State Government Organization and Economy",7,0,0,0,0,0,7
2021-12,"8830 - Law Revision Commission, California",7,0,0,0,0,0,7
2021-12,8860 - Department of Finance,191,96,36,32,13,10,378
2021-12,8880 - Financial Information System for California,268,7,6,1,2,0,284
2021-12,"8885 - States Mandates, Commission on",1,9,0,1,0,0,11
2021-12,8940 - Military Department,10,5,3,15,5,0,38
2021-12,8955 - Department of Veterans Affairs,189,49,106,45,26,14,429
2021-12,A059 - California Correctional Health Care Services,722,258,465,453,168,155,2221
2021-12,A314 - California Science Center,2,0,0,26,2,2,32
2021-12,A341 - California Earthquake Authority,74,2,3,2,0,1,82
2021-12,A424 - Cradle-to-Career,4,0,1,0,0,0,5
2021-12,A541 - Board of Forestry and Fire Protection,0,1,0,0,0,0,1
2022-01,0500 - Governor's Office,53,14,11,19,5,13,115
2022-01,0509 - Governor's Office of Business and Economic Development (GO-Biz),96,16,5,5,5,1,128
2022-01,0511 - Secretary for Government Operations Agency,24,1,4,0,0,0,29
2022-01,"0515 - Secretary for Business, Consumer Services, and Housing Agency",35,11,3,2,0,1,52
2022-01,0521 - Secretary for Transportation Agency,0,19,0,2,0,1,22
2022-01,0531 - Office of Systems Integration,281,48,6,1,1,0,337
2022-01,0540 - Secretary of the Natural Resources Agency,76,0,1,8,0,0,85
2022-01,0552 - Office of the Inspector General,108,7,3,1,0,13,132
2022-01,0555 - Secretary for Environmental Protection,57,2,4,0,0,5,68
2022-01,0559 - Secretary for Labor and Workforce Development Agency,3,3,8,8,2,4,28
2022-01,0650 - Office of Planning and Research,90,8,10,11,2,0,121
2022-01,0690 - Governor's Office of Emergency Services,515,115,148,101,55,120,1054
2022-01,0820 - Department of Justice,1620,538,511,528,321,359,3877
2022-01,0855 - California Gambling Control Commission,18,15,3,2,0,0,38
2022-01,0860 - State Board of Equalization,152,0,0,8,0,0,160
2022-01,0890 - Secretary of State,101,0,392,40,22,8,563
2022-01,1045 - Cannabis Control Appeals Panel,5,1,0,1,1,0,8
2022-01,1111 - Department of Consumer Affairs,657,441,484,338,291,284,2495
2022-01,1115 - Department of Cannabis Control,255,20,36,13,1,70,395
2022-01,1700 - California Civil Rights Department,197,37,18,3,2,5,262
2022-01,1701 - Department of Financial Protection and Innovation,575,24,38,34,2,10,683
2022-01,1703 - California Privacy Protection Agency,2,0,0,0,0,1,3
2022-01,1750 - California Horse Racing Board,11,2,8,1,4,1,27
2022-01,2100 - Department of Alcoholic Beverage Control,46,33,92,150,89,2,412
2022-01,2120 - Alcoholic Beverage Control Appeals Board,2,1,2,1,0,0,6
2022-01,2240 - Department of Housing and Community Development,529,72,81,77,9,88,856
2022-01,2320 - Department of Real Estate,22,121,136,18,24,7,328
2022-01,2600 - California Transportation Commission,23,10,4,0,0,0,37
2022-01,2665 - High-Speed Rail Authority,172,28,43,26,13,11,293
2022-01,2720 - California Highway Patrol,0,150,0,319,0,1020,1489
2022-01,3105 - California African-American Museum,0,0,0,18,0,0,18
2022-01,3125 - California Tahoe Conservancy,41,0,0,0,0,1,42
2022-01,3340 - California Conservation Corps,0,88,9,49,0,0,146
2022-01,3355 - Office of Energy Infrastructure Safety,44,0,0,0,0,0,44
2022-01,3360 - Energy Resources Conservation and Development Commission,525,43,18,9,3,0,598
2022-01,3480 - Department of Conservation,328,87,87,58,21,33,614
2022-01,3540 - Department of Forestry and Fire Protection,68,45,40,29,13,4,199
2022-01,3560 - State Lands Commission,115,14,28,5,6,2,170
2022-01,3600 - Department of Fish and Wildlife,819,111,154,52,21,665,1822
2022-01,3640 - Wildlife Conservation Board,14,0,1,1,0,16,32
2022-01,3720 - California Coastal Commission,0,178,0,0,0,0,178
2022-01,3760 - State Coastal Conservancy,41,8,3,2,0,0,54
2022-01,3780 - Native American Heritage Commission,7,0,0,1,0,0,8
2022-01,3790 - Department of Parks and Recreation,370,108,103,187,136,260,1164
2022-01,3810 - Santa Monica Mountains Conservancy,7,0,0,0,0,0,7
2022-01,3820 - San Francisco Bay Conservation and Development Commission,48,0,0,0,0,0,48
2022-01,3825 - San Gabriel and Lower Los Angeles Rivers and Mountains Conservancy,0,8,1,0,0,0,9
2022-01,3830 - San Joaquin River Conservancy,2,1,0,0,0,0,3
2022-01,3835 - Baldwin Hills Conservancy,2,1,0,0,0,0,3
2022-01,3840 - Delta Protection Commission,2,2,0,0,1,1,6
2022-01,3845 - San Diego River Conservancy,0,0,0,0,0,3,3
2022-01,3850 - Coachella Valley Mountains Conservancy,0,0,2,1,1,0,4
2022-01,3855 - Sierra Nevada Conservancy,28,7,1,3,0,0,39
2022-01,3860 - Department of Water Resources,693,677,438,235,200,39,2282
2022-01,3862 - Central Valley Flood Protection Board,38,1,4,0,1,0,44
2022-01,3875 - Sacramento-San Joaquin Delta Conservancy,10,1,0,0,0,0,11
2022-01,3885 - Delta Stewardship Council,29,14,10,1,1,0,55
2022-01,3900 - State Air Resources Board,820,456,171,76,41,9,1573
2022-01,3930 - Department of Pesticide Regulation,231,99,61,17,4,9,421
2022-01,3940 - State Water Resources Control Board,1769,123,82,84,16,246,2320
2022-01,3960 - Department of Toxic Substances Control,360,226,94,68,38,210,996
2022-01,3970 - Department of Resources Recycling and Recovery,501,118,57,27,22,39,764
2022-01,4100 - State Council on Developmental Disabilities,30,6,13,6,6,5,66
2022-01,4140 - Department of Health Care Access and Information,338,47,15,28,11,9,448
2022-01,4150 - Department of Managed Health Care,477,4,2,0,0,0,483
2022-01,4170 - Department of Aging,163,3,4,4,0,1,175
2022-01,4250 - California Children and Families Commission,2,0,32,2,0,0,36
2022-01,4260 - State Department of Health Care Services,1478,756,223,248,54,703,3462
2022-01,4265 - Department of Public Health,2456,137,112,83,24,1126,3938
2022-01,4300 - Department of Developmental Services,373,85,37,32,7,23,557
2022-01,4440 - Department of State Hospitals,282,270,87,178,149,50,1016
2022-01,4700 - Department of Community Services and Development,102,2,0,1,1,1,107
2022-01,4800 - California Health Benefit Exchange,1262,2,12,33,1,20,1330
2022-01,5160 - Department of Rehabilitation,271,258,487,403,96,110,1625
2022-01,5175 - Department of Child Support Services,488,59,17,10,15,0,589
2022-01,5180 - Department of Social Services,2285,487,614,1377,388,0,5151
2022-01,5225 - Department of Corrections and Rehabilitation,1340,573,429,571,251,1368,4532
2022-01,5227 - Board of State and Community Corrections,94,1,0,1,1,0,97
2022-01,5420 - Prison Industry Authority,44,37,108,52,10,1,252
2022-01,6120 - California State Library,52,18,14,32,27,2,145
2022-01,6125 - Education Audit Appeals Panel,0,2,1,0,0,0,3
2022-01,6250 - California School for the Deaf - Riverside,0,2,1,10,0,6,19
2022-01,6360 - Commission on Teacher Credentialing,79,39,15,4,4,3,144
2022-01,6870 - Board of Governors of the California Community Colleges,164,1,5,1,0,0,171
2022-01,"6980 - Student Aid Commission, California",138,0,0,0,0,0,138
2022-01,7100 - Employment Development Department,7298,168,758,518,26,26,8794
2022-01,7300 - Agricultural Labor Relations Board,13,6,32,4,1,4,60
2022-01,7320 - Public Employment Relations Board,21,26,17,4,4,1,73
2022-01,7501 - Department of Human Resources,217,35,20,13,6,8,299
2022-01,7502 - California Department of Technology,722,42,34,7,7,87,899
2022-01,7503 - State Personnel Board,54,13,6,2,0,0,75
2022-01,7504 - Office of Data and Innovation,19,0,0,0,0,0,19
2022-01,7600 - California Department of Tax and Fee Administration,2477,521,329,114,12,21,3474
2022-01,7730 - Franchise Tax Board,2760,577,95,91,44,1514,5081
2022-01,7760 - Department of General Services,1126,185,95,81,75,381,1943
2022-01,7870 - California Victim Compensation Board,43,151,16,10,0,2,222
2022-01,7910 - Office of Administrative Law,0,9,4,5,3,0,21
2022-01,7920 - State Teachers' Retirement System,1280,2,2,0,0,0,1284
2022-01,8120 - Commission on Peace Officer Standards and Training,119,0,0,9,2,2,132
2022-01,8140 - State Public Defender,45,5,7,13,2,9,81
2022-01,8560 - California Exposition and State Fair,0,1,0,1,0,0,2
2022-01,8570 - Department of Food and Agriculture,231,61,65,50,22,62,491
2022-01,8620 - Fair Political Practices Commission,81,2,0,0,0,0,83
2022-01,8660 - Public Utilities Commission,333,702,140,56,13,0,1244
2022-01,"8780 - Milton Marks ""Little Hoover"" Commission on California State Government Organization and Economy",7,0,0,0,0,0,7
2022-01,"8830 - Law Revision Commission, California",7,0,0,0,0,0,7
2022-01,8860 - Department of Finance,191,96,36,32,13,10,378
2022-01,8880 - Financial Information System for California,269,14,7,1,0,0,291
2022-01,"8885 - States Mandates, Commission on",1,9,0,1,0,0,11
2022-01,8940 - Military Department,6,9,36,18,0,1,70
2022-01,8955 - Department of Veterans Affairs,189,49,107,45,26,14,430
2022-01,A059 - California Correctional Health Care Services,699,247,464,447,149,149,2155
2022-01,A314 - California Science Center,2,0,0,26,2,2,32
2022-01,A341 - California Earthquake Authority,70,0,5,2,0,1,78
2022-01,A424 - Cradle-to-Career,6,0,1,0,0,0,7
2022-01,A541 - Board of Forestry and Fire Protection,0,1,0,0,0,0,1
2022-02,0500 - Governor's Office,43,20,17,18,6,14,118
2022-02,0509 - Governor's Office of Business and Economic Development (GO-Biz),88,16,5,5,5,2,121
2022-02,0511 - Secretary for Government Operations Agency,24,2,4,0,0,0,30
2022-02,"0515 - Secretary for Business, Consumer Services, and Housing Agency",36,11,3,2,0,2,54
2022-02,0521 - Secretary for Transportation Agency,0,19,0,2,0,1,22
2022-02,0531 - Office of Systems Integration,301,26,3,4,2,0,336
2022-02,0540 - Secretary of the Natural Resources Agency,76,0,1,8,0,0,85
2022-02,0552 - Office of the Inspector General,95,15,3,5,2,11,131
2022-02,0555 - Secretary for Environmental Protection,60,2,4,0,0,5,71
2022-02,0559 - Secretary for Labor and Workforce Development Agency,3,3,8,8,2,4,28
2022-02,0650 - Office of Planning and Research,90,8,10,11,2,0,121
2022-02,0690 - Governor's Office of Emergency Services,396,106,226,111,65,130,1034
2022-02,0820 - Department of Justice,1620,538,511,528,321,359,3877
2022-02,0855 - California Gambling Control Commission,19,14,3,2,0,0,38
2022-02,0860 - State Board of Equalization,152,0,0,8,0,0,160
2022-02,0890 - Secretary of State,101,0,392,40,22,8,563
2022-02,1045 - Cannabis Control Appeals Panel,5,1,0,1,1,0,8
2022-02,1111 - Department of Consumer Affairs,631,451,496,323,305,279,2485
2022-02,1115 - Department of Cannabis Control,245,24,45,22,46,14,396
2022-02,1700 - California Civil Rights Department,197,37,18,3,2,5,262
2022-02,1701 - Department of Financial Protection and Innovation,572,24,40,33,2,7,678
2022-02,1703 - California Privacy Protection Agency,4,0,0,0,0,1,5
2022-02,1750 - California Horse Racing Board,12,2,9,1,4,1,29
2022-02,2100 - Department of Alcoholic Beverage Control,52,36,65,173,87,41,454
2022-02,2120 - Alcoholic Beverage Control Appeals Board,2,1,2,1,0,0,6
2022-02,2240 - Department of Housing and Community Development,561,76,87,83,12,86,905
2022-02,2320 - Department of Real Estate,22,121,136,18,24,7,328
2022-02,2600 - California Transportation Commission,22,10,4,0,0,1,37
2022-02,2665 - High-Speed Rail Authority,171,29,42,28,12,8,290
2022-02,2720 - California Highway Patrol,0,150,0,322,0,1017,1489
2022-02,3105 - California African-American Museum,0,0,0,18,0,0,18
2022-02,3125 - California Tahoe Conservancy,41,0,0,0,0,1,42
2022-02,3340 - California Conservation Corps,40,40,16,45,13,1,155
2022-02,3355 - Office of Energy Infrastructure Safety,45,0,0,0,0,1,46
2022-02,3360 - Energy Resources Conservation and Development Commission,552,44,22,10,5,1,634
2022-02,3480 - Department of Conservation,328,88,87,61,22,33,619
2022-02,3540 - Department of Forestry and Fire Protection,72,53,47,34,17,4,227
2022-02,3560 - State Lands Commission,114,14,28,5,6,2,169
2022-02,3600 - Department of Fish and Wildlife,983,164,160,79,40,418,1844
2022-02,3640 - Wildlife Conservation Board,24,1,2,1,0,5,33
2022-02,3720 - California Coastal Commission,0,178,0,0,0,0,178
2022-02,3760 - State Coastal Conservancy,41,8,3,2,2,0,56
2022-02,3780 - Native American Heritage Commission,7,0,0,1,0,0,8
2022-02,3790 - Department of Parks and Recreation,365,109,106,166,141,224,1111
2022-02,3810 - Santa Monica Mountains Conservancy,7,0,0,0,0,0,7
2022-02,3820 - San Francisco Bay Conservation and Development Commission,48,0,0,0,0,0,48
2022-02,3825 - San Gabriel and Lower Los Angeles Rivers and Mountains Conservancy,1,6,2,0,0,0,9
2022-02,3830 - San Joaquin River Conservancy,2,1,0,0,0,0,3
2022-02,3835 - Baldwin Hills Conservancy,2,0,1,0,0,0,3
2022-02,3840 - Delta Protection Commission,3,1,0,0,1,2,7
2022-02,3845 - San Diego River Conservancy,0,0,0,0,0,3,3
2022-02,3850 - Coachella Valley Mountains Conservancy,0,0,2,1,1,0,4
2022-02,3855 - Sierra Nevada Conservancy,20,11,2,5,1,0,39
2022-02,3860 - Department of Water Resources,628,691,400,316,202,15,2252
2022-02,3862 - Central Valley Flood Protection Board,38,1,4,6,2,0,51
2022-02,3875 - Sacramento-San Joaquin Delta Conservancy,10,1,0,0,0,0,11
2022-02,3885 - Delta Stewardship Council,29,14,10,1,1,0,55
2022-02,3900 - State Air Resources Board,743,498,139,125,48,23,1576
2022-02,3930 - Department of Pesticide Regulation,231,109,42,24,4,10,420
2022-02,3940 - State Water Resources Control Board,1798,124,83,85,16,281,2387
2022-02,3960 - Department of Toxic Substances Control,385,269,105,57,31,160,1007
2022-02,3970 - Department of Resources Recycling and Recovery,480,114,48,23,18,59,742
2022-02,4100 - State Council on Developmental Disabilities,30,6,13,6,6,5,66
2022-02,4140 - Department of Health Care Access and Information,358,34,15,22,9,10,448
2022-02,4150 - Department of Managed Health Care,469,5,2,0,0,0,476
2022-02,4170 - Department of Aging,171,9,5,4,1,1,191
2022-02,4250 - California Children and Families Commission,2,0,33,2,0,0,37
2022-02,4260 - State Department of Health Care Services,1506,795,255,244,56,983,3839
2022-02,4265 - Department of Public Health,2456,137,112,83,24,1126,3938
2022-02,4300 - Department of Developmental Services,371,84,41,34,6,22,558
2022-02,4440 - Department of State Hospitals,300,280,92,172,161,83,1088
2022-02,4700 - Department of Community Services and Development,106,0,0,0,0,0,106
2022-02,4800 - California Health Benefit Exchange,1104,58,55,30,9,20,1276
2022-02,5160 - Department of Rehabilitation,275,261,482,430,93,146,1687
2022-02,5175 - Department of Child Support Services,488,59,17,10,15,0,589
2022-02,5180 - Department of Social Services,2285,487,614,1377,388,0,5151
2022-02,5225 - Department of Corrections and Rehabilitation,1558,366,427,571,250,1300,4472
2022-02,5227 - Board of State and Community Corrections,96,1,2,1,1,1,102
2022-02,5420 - Prison Industry Authority,45,35,104,45,10,7,246
2022-02,6120 - California State Library,51,17,14,32,26,3,143
2022-02,6125 - Education Audit Appeals Panel,0,2,1,0,0,0,3
2022-02,6250 - California School for the Deaf - Riverside,0,2,1,10,0,6,19
2022-02,6360 - Commission on Teacher Credentialing,78,38,14,5,4,2,141
2022-02,6870 - Board of Governors of the California Community Colleges,161,0,5,1,0,0,167
2022-02,"6980 - Student Aid Commission, California",138,0,0,0,0,0,138
2022-02,7100 - Employment Development Department,7173,77,739,499,16,98,8602
2022-02,7300 - Agricultural Labor Relations Board,11,6,34,4,1,6,62
2022-02,7320 - Public Employment Relations Board,21,26,16,4,4,1,72
2022-02,7501 - Department of Human Resources,155,92,22,10,8,7,294
2022-02,7502 - California Department of Technology,868,34,4,0,0,0,906
2022-02,7503 - State Personnel Board,53,18,2,1,0,1,75
2022-02,7504 - Office of Data and Innovation,18,0,0,0,0,0,18
2022-02,7600 - California Department of Tax and Fee Administration,2459,528,321,118,11,20,3457
2022-02,7730 - Franchise Tax Board,2744,573,93,91,44,1514,5059
2022-02,7760 - Department of General Services,1124,187,97,82,72,383,1945
2022-02,7870 - California Victim Compensation Board,3,187,16,11,0,9,226
2022-02,7910 - Office of Administrative Law,0,9,4,5,3,0,21
2022-02,7920 - State Teachers' Retirement System,1278,2,2,0,0,0,1282
2022-02,8120 - Commission on Peace Officer Standards and Training,0,0,0,9,115,3,127
2022-02,8140 - State Public Defender,45,5,7,13,2,10,82
2022-02,8560 - California Exposition and State Fair,0,1,0,1,0,0,2
2022-02,8570 - Department of Food and Agriculture,418,124,138,96,56,173,1005
2022-02,8620 - Fair Political Practices Commission,79,2,0,0,0,1,82
2022-02,8660 - Public Utilities Commission,889,168,137,56,13,2,1265
2022-02,"8780 - Milton Marks ""Little Hoover"" Commission on California State Government Organization and Economy",7,0,0,0,0,0,7
2022-02,"8830 - Law Revision Commission, California",7,0,0,0,0,0,7
2022-02,8860 - Department of Finance,192,98,81,9,0,0,380
2022-02,8880 - Financial Information System for California,266,16,7,1,2,0,292
2022-02,"8885 - States Mandates, Commission on",6,4,0,1,0,0,11
2022-02,8940 - Military Department,6,9,36,19,0,2,72
2022-02,8955 - Department of Veterans Affairs,189,50,108,45,26,14,432
2022-02,A059 - California Correctional Health Care Services,581,302,230,299,156,137,1705
2022-02,A314 - California Science Center,2,0,0,26,2,2,32
2022-02,A341 - California Earthquake Authority,71,3,3,2,0,1,80
2022-02,A424 - Cradle-to-Career,3,0,3,0,0,0,6
2022-02,A541 - Board of Forestry and Fire Protection,4,1,3,1,0,0,9
2022-03,0500 - Governor's Office,21,26,23,26,12,11,119
2022-03,0509 - Governor's Office of Business and Economic Development (GO-Biz),86,22,5,5,5,2,125
2022-03,0511 - Secretary for Government Operations Agency,27,0,4,0,0,0,31
2022-03,"0515 - Secretary for Business, Consumer Services, and Housing Agency",38,11,2,2,0,2,55
2022-03,0521 - Secretary for Transportation Agency,0,19,0,2,0,1,22
2022-03,0531 - Office of Systems Integration,312,19,7,0,2,0,340
2022-03,0540 - Secretary of the Natural Resources Agency,76,0,1,8,0,0,85
2022-03,0552 - Office of the Inspector General,97,11,3,5,3,11,130
2022-03,0555 - Secretary for Environmental Protection,60,2,4,0,0,5,71
2022-03,0559 - Secretary for Labor and Workforce Development Agency,3,3,8,8,2,4,28
2022-03,0650 - Office of Planning and Research,95,24,22,2,0,0,143
2022-03,0690 - Governor's Office of Emergency Services,350,116,152,204,77,148,1047
2022-03,0820 - Department of Justice,1620,538,511,528,321,359,3877
2022-03,0855 - California Gambling Control Commission,22,12,3,2,0,0,39
2022-03,0860 - State Board of Equalization,150,0,4,8,0,1,163
2022-03,0890 - Secretary of State,101,0,392,40,22,8,563
2022-03,1045 - Cannabis Control Appeals Panel,5,1,0,1,1,0,8
2022-03,1111 - Department of Consumer Affairs,553,426,403,367,297,299,2345
2022-03,1115 - Department of Cannabis Control,213,47,53,22,51,14,400
2022-03,1700 - California Civil Rights Department,197,37,18,3,2,5,262
2022-03,1701 - Department of Financial Protection and Innovation,582,24,39,34,3,5,687
2022-03,1703 - California Privacy Protection Agency,5,0,0,0,0,1,6
2022-03,1750 - California Horse Racing Board,12,2,9,1,4,1,29
2022-03,2100 - Department of Alcoholic Beverage Control,52,36,65,173,87,41,454
2022-03,2120 - Alcoholic Beverage Control Appeals Board,2,1,2,1,0,0,6
2022-03,2240 - Department of Housing and Community Development,574,78,91,85,12,88,928
2022-03,2320 - Department of Real Estate,22,124,133,19,14,19,331
2022-03,2600 - California Transportation Commission,23,2,7,2,1,1,36
2022-03,2665 - High-Speed Rail Authority,168,36,39,26,16,7,292
2022-03,2700 - California Traffic Safety Program,2,26,2,1,0,0,31
2022-03,2720 - California Highway Patrol,0,150,0,326,0,1014,1490
2022-03,3100 - Exposition Park,2,0,0,46,2,3,53
2022-03,3105 - California African-American Museum,0,0,0,18,0,0,18
2022-03,3125 - California Tahoe Conservancy,41,0,0,1,2,1,45
2022-03,3340 - California Conservation Corps,42,37,20,36,16,1,152
2022-03,3355 - Office of Energy Infrastructure Safety,48,0,0,0,0,4,52
2022-03,3360 - Energy Resources Conservation and Development Commission,573,46,22,11,5,1,658
2022-03,3480 - Department of Conservation,331,88,88,61,22,33,623
2022-03,3540 - Department of Forestry and Fire Protection,99,68,55,47,25,6,300
2022-03,3560 - State Lands Commission,115,14,27,5,6,2,169
2022-03,3600 - Department of Fish and Wildlife,1026,187,172,94,59,384,1922
2022-03,3640 - Wildlife Conservation Board,24,1,2,1,0,4,32
2022-03,3720 - California Coastal Commission,0,178,0,0,0,0,178
2022-03,3760 - State Coastal Conservancy,41,8,3,2,2,0,56
2022-03,3780 - Native American Heritage Commission,7,0,0,1,0,0,8
2022-03,3790 - Department of Parks and Recreation,361,112,107,172,138,222,1112
2022-03,3810 - Santa Monica Mountains Conservancy,7,0,0,0,0,0,7
2022-03,3820 - San Francisco Bay Conservation and Development Commission,48,0,0,0,0,0,48
2022-03,3825 - San Gabriel and Lower Los Angeles Rivers and Mountains Conservancy,1,7,1,0,0,0,9
2022-03,3830 - San Joaquin River Conservancy,2,1,0,0,0,0,3
2022-03,3835 - Baldwin Hills Conservancy,2,0,1,0,0,0,3
2022-03,3840 - Delta Protection Commission,4,1,0,0,1,1,7
2022-03,3845 - San Diego River Conservancy,0,0,0,0,0,3,3
2022-03,3850 - Coachella Valley Mountains Conservancy,0,0,2,1,1,0,4
2022-03,3855 - Sierra Nevada Conservancy,20,9,5,6,0,0,40
2022-03,3860 - Department of Water Resources,651,645,396,317,231,5,2245
2022-03,3862 - Central Valley Flood Protection Board,40,1,4,0,1,0,46
2022-03,3875 - Sacramento-San Joaquin Delta Conservancy,10,1,0,0,0,0,11
2022-03,3885 - Delta Stewardship Council,29,14,10,1,1,0,55
2022-03,3900 - State Air Resources Board,841,370,182,115,85,26,1619
2022-03,3930 - Department of Pesticide Regulation,220,109,51,21,13,11,425
2022-03,3940 - State Water Resources Control Board,1781,125,80,83,16,339,2424
2022-03,3960 - Department of Toxic Substances Control,334,292,129,51,37,163,1006
2022-03,3970 - Department of Resources Recycling and Recovery,512,101,86,25,11,15,750
2022-03,3980 - Office of Environmental Health Hazard Assessment,111,18,5,1,0,0,135
2022-03,4100 - State Council on Developmental Disabilities,30,6,13,6,6,5,66
2022-03,4140 - Department of Health Care Access and Information,187,54,14,113,12,74,454
2022-03,4150 - Department of Managed Health Care,471,5,3,0,0,1,480
2022-03,4170 - Department of Aging,164,9,6,4,2,3,188
2022-03,4250 - California Children and Families Commission,2,0,32,2,0,0,36
2022-03,4260 - State Department of Health Care Services,1504,788,240,231,53,997,3813
2022-03,4265 - Department of Public Health,2456,137,112,83,24,1126,3938
2022-03,4300 - Department of Developmental Services,383,88,33,22,13,3,542
2022-03,4440 - Department of State Hospitals,304,275,111,167,197,114,1168
2022-03,4700 - Department of Community Services and Development,101,2,1,0,1,1,106
2022-03,4800 - California Health Benefit Exchange,1147,60,55,31,9,50,1352
2022-03,5160 - Department of Rehabilitation,248,224,520,407,118,155,1672
2022-03,5175 - Department of Child Support Services,486,59,17,10,15,0,587
2022-03,5180 - Department of Social Services,2285,487,614,1377,388,0,5151
2022-03,5225 - Department of Corrections and Rehabilitation,1552,327,533,571,253,0,3236
2022-03,5227 - Board of State and Community Corrections,104,1,2,1,2,0,110
2022-03,5420 - Prison Industry Authority,45,34,104,50,8,4,245
2022-03,6120 - California State Library,52,20,17,27,24,4,144
2022-03,6125 - Education Audit Appeals Panel,0,2,1,0,0,0,3
2022-03,6250 - California School for the Deaf - Riverside,0,2,1,10,0,6,19
2022-03,6360 - Commission on Teacher Credentialing,78,40,14,6,4,1,143
2022-03,6870 - Board of Governors of the California Community Colleges,161,0,4,1,0,0,166
2022-03,"6980 - Student Aid Commission, California",138,0,0,0,0,0,138
2022-03,7100 - Employment Development Department,7115,86,753,466,14,80,8514
2022-03,7300 - Agricultural Labor Relations Board,11,6,34,4,1,6,62
2022-03,7320 - Public Employment Relations Board,8,25,18,7,3,3,64
2022-03,7501 - Department of Human Resources,140,59,59,14,5,10,287
2022-03,7502 - California Department of Technology,739,46,32,7,7,83,914
2022-03,7503 - State Personnel Board,54,15,4,0,1,1,75
2022-03,7504 - Office of Data and Innovation,20,0,0,0,0,0,20
2022-03,7600 - California Department of Tax and Fee Administration,2545,557,337,118,13,25,3595
2022-03,7730 - Franchise Tax Board,2939,586,146,85,53,1262,5071
2022-03,7760 - Department of General Services,1119,188,94,83,74,395,1953
2022-03,7870 - California Victim Compensation Board,4,184,16,11,0,9,224
2022-03,7910 - Office of Administrative Law,0,9,4,5,3,0,21
2022-03,7920 - State Teachers' Retirement System,1270,2,2,0,0,0,1274
2022-03,8120 - Commission on Peace Officer Standards and Training,0,0,0,127,1,2,130
2022-03,8140 - State Public Defender,43,4,9,13,2,10,81
2022-03,8560 - California Exposition and State Fair,0,1,0,1,0,0,2
2022-03,8570 - Department of Food and Agriculture,177,96,80,71,43,103,570
2022-03,8620 - Fair Political Practices Commission,79,2,0,0,0,1,82
2022-03,8660 - Public Utilities Commission,536,528,146,61,16,0,1287
2022-03,"8780 - Milton Marks ""Little Hoover"" Commission on California State Government Organization and Economy",7,0,0,0,0,0,7
2022-03,8825 - Commission on Asian and Pacific Islander American Affairs,3,0,0,0,0,0,3
2022-03,"8830 - Law Revision Commission, California",9,0,0,0,0,0,9
2022-03,8860 - Department of Finance,187,99,84,8,0,0,378
2022-03,8880 - Financial Information System for California,270,14,5,2,1,0,292
2022-03,"8885 - States Mandates, Commission on",6,4,0,1,0,0,11
2022-03,8940 - Military Department,6,10,36,20,0,2,74
2022-03,8955 - Department of Veterans Affairs,189,50,108,45,26,14,432
2022-03,A059 - California Correctional Health Care Services,624,260,339,204,208,0,1635
2022-03,A314 - California Science Center,2,0,0,25,2,3,32
2022-03,A341 - California Earthquake Authority,69,4,4,2,0,1,80
2022-03,A424 - Cradle-to-Career,3,0,3,0,0,0,6
2022-03,A541 - Board of Forestry and Fire Protection,0,0,0,0,0,0,0
2022-04,0500 - Governor's Office,18,23,25,25,15,11,117
2022-04,0509 - Governor's Office of Business and Economic Development (GO-Biz),90,21,4,3,5,5,128
2022-04,0511 - Secretary for Government Operations Agency,24,1,2,2,0,0,29
2022-04,"0515 - Secretary for Business, Consumer Services, and Housing Agency",39,11,2,4,0,2,58
2022-04,0521 - Secretary for Transportation Agency,0,19,0,2,0,1,22
2022-04,0531 - Office of Systems Integration,308,26,3,3,2,0,342
2022-04,0540 - Secretary of the Natural Resources Agency,67,0,11,0,4,2,84
2022-04,0552 - Office of the Inspector General,97,12,6,2,2,10,129
2022-04,0555 - Secretary for Environmental Protection,60,2,4,0,0,5,71
2022-04,0559 - Secretary for Labor and Workforce Development Agency,3,3,8,8,2,4,28
2022-04,0650 - Office of Planning and Research,98,24,22,2,0,0,146
2022-04,0690 - Governor's Office of Emergency Services,37,236,179,211,170,289,1122
2022-04,0820 - Department of Justice,1620,538,511,528,321,359,3877
2022-04,0845 - Department of Insurance,519,200,55,28,167,3,972
2022-04,0855 - California Gambling Control Commission,27,9,3,0,0,0,39
2022-04,0860 - State Board of Equalization,150,0,2,8,0,1,161
2022-04,0890 - Secretary of State,101,0,392,40,22,8,563
2022-04,1045 - Cannabis Control Appeals Panel,5,1,0,1,1,0,8
2022-04,1111 - Department of Consumer Affairs,589,469,440,391,296,279,2464
2022-04,1115 - Department of Cannabis Control,193,23,59,23,53,10,361
2022-04,1700 - California Civil Rights Department,191,36,21,3,2,5,258
2022-04,1701 - Department of Financial Protection and Innovation,584,24,39,34,4,2,687
2022-04,1703 - California Privacy Protection Agency,6,0,0,0,0,1,7
2022-04,1750 - California Horse Racing Board,11,2,8,1,4,1,27
2022-04,2100 - Department of Alcoholic Beverage Control,42,19,54,78,73,202,468
2022-04,2120 - Alcoholic Beverage Control Appeals Board,2,1,2,1,0,0,6
2022-04,2240 - Department of Housing and Community Development,608,80,94,91,13,97,983
2022-04,2320 - Department of Real Estate,22,114,126,18,12,16,308
2022-04,2600 - California Transportation Commission,23,2,7,2,1,1,36
2022-04,2660 - Department of Transportation,2683,2717,5570,1238,344,115,12667
2022-04,2665 - High-Speed Rail Authority,173,49,34,21,15,4,296
2022-04,2700 - California Traffic Safety Program,2,26,2,1,0,0,31
2022-04,2720 - California Highway Patrol,0,146,0,328,0,1011,1485
2022-04,3100 - Exposition Park,4,0,0,50,4,6,64
2022-04,3105 - California African-American Museum,0,0,0,18,0,0,18
2022-04,3125 - California Tahoe Conservancy,41,0,0,1,2,1,45
2022-04,3340 - California Conservation Corps,44,35,20,36,16,1,152
2022-04,3355 - Office of Energy Infrastructure Safety,49,0,0,0,0,1,50
2022-04,3360 - Energy Resources Conservation and Development Commission,571,45,22,11,5,1,655
2022-04,3480 - Department of Conservation,331,88,87,60,22,33,621
2022-04,3540 - Department of Forestry and Fire Protection,132,100,98,92,38,6,466
2022-04,3560 - State Lands Commission,116,14,27,5,5,2,169
2022-04,3600 - Department of Fish and Wildlife,1032,185,180,103,56,370,1926
2022-04,3640 - Wildlife Conservation Board,23,1,2,1,0,5,32
2022-04,3720 - California Coastal Commission,0,178,0,0,0,0,178
2022-04,3760 - State Coastal Conservancy,42,10,4,2,0,0,58
2022-04,3780 - Native American Heritage Commission,7,0,0,1,0,0,8
2022-04,3790 - Department of Parks and Recreation,326,121,111,165,136,209,1068
2022-04,3810 - Santa Monica Mountains Conservancy,7,0,0,0,0,0,7
2022-04,3820 - San Francisco Bay Conservation and Development Commission,47,0,0,0,0,0,47
2022-04,3825 - San Gabriel and Lower Los Angeles Rivers and Mountains Conservancy,1,7,1,0,0,0,9
2022-04,3830 - San Joaquin River Conservancy,2,1,0,0,0,0,3
2022-04,3835 - Baldwin Hills Conservancy,2,0,1,0,0,0,3
2022-04,3840 - Delta Protection Commission,5,0,0,1,1,0,7
2022-04,3845 - San Diego River Conservancy,0,0,0,0,0,3,3
2022-04,3850 - Coachella Valley Mountains Conservancy,0,0,2,1,1,0,4
2022-04,3855 - Sierra Nevada Conservancy,20,8,6,6,1,0,41
2022-04,3860 - Department of Water Resources,549,626,436,386,239,45,2281
2022-04,3862 - Central Valley Flood Protection Board,40,1,4,1,2,0,48
2022-04,3875 - Sacramento-San Joaquin Delta Conservancy,10,1,0,0,0,0,11
2022-04,3885 - Delta Stewardship Council,29,14,10,1,1,0,55
2022-04,3900 - State Air Resources Board,668,447,228,124,104,0,1571
2022-04,3930 - Department of Pesticide Regulation,209,107,60,26,12,12,426
2022-04,3940 - State Water Resources Control Board,1700,118,80,75,16,545,2534
2022-04,3960 - Department of Toxic Substances Control,514,127,50,105,58,163,1017
2022-04,3970 - Department of Resources Recycling and Recovery,484,101,101,41,12,10,749
2022-04,3980 - Office of Environmental Health Hazard Assessment,111,18,5,1,0,0,135
2022-04,4100 - State Council on Developmental Disabilities,30,6,13,6,6,5,66
2022-04,4140 - Department of Health Care Access and Information,185,51,16,114,15,75,456
2022-04,4150 - Department of Managed Health Care,474,6,3,0,0,1,484
2022-04,4170 - Department of Aging,167,9,7,3,2,5,193
2022-04,4250 - California Children and Families Commission,2,0,33,2,0,0,37
2022-04,4260 - State Department of Health Care Services,1480,774,235,228,53,1069,3839
2022-04,4265 - Department of Public Health,2456,137,112,83,24,1126,3938
2022-04,4300 - Department of Developmental Services,379,91,33,22,13,20,558
2022-04,4440 - Department of State Hospitals,307,280,128,175,191,120,1201
2022-04,4700 - Department of Community Services and Development,101,2,5,0,1,1,110
2022-04,4800 - California Health Benefit Exchange,1141,61,47,34,9,54,1346
2022-04,5160 - Department of Rehabilitation,249,222,516,423,105,154,1669
2022-04,5175 - Department of Child Support Services,489,59,17,10,16,0,591
2022-04,5180 - Department of Social Services,2285,487,614,1377,388,0,5151
2022-04,5225 - Department of Corrections and Rehabilitation,162,31,64,81,32,0,370
2022-04,5227 - Board of State and Community Corrections,107,1,2,1,2,0,113
2022-04,5420 - Prison Industry Authority,36,34,95,46,7,1,219
2022-04,6120 - California State Library,52,20,16,28,24,4,144
2022-04,6125 - Education Audit Appeals Panel,0,2,1,0,0,0,3
2022-04,6250 - California School for the Deaf - Riverside,0,2,1,10,0,6,19
2022-04,6360 - Commission on Teacher Credentialing,78,39,16,8,1,5,147
2022-04,6870 - Board of Governors of the California Community Colleges,160,0,4,1,0,0,165
2022-04,"6980 - Student Aid Commission, California",138,0,0,0,0,0,138
2022-04,7100 - Employment Development Department,6960,0,749,405,0,0,8114
2022-04,7300 - Agricultural Labor Relations Board,10,6,36,4,1,5,62
2022-04,7320 - Public Employment Relations Board,8,25,18,6,3,3,63
2022-04,7501 - Department of Human Resources,139,57,56,16,6,13,287
2022-04,7502 - California Department of Technology,753,45,29,7,7,78,919
2022-04,7503 - State Personnel Board,56,11,5,0,2,0,74
2022-04,7504 - Office of Data and Innovation,22,0,0,0,0,0,22
2022-04,7600 - California Department of Tax and Fee Administration,2542,557,346,109,12,8,3574
2022-04,7730 - Franchise Tax Board,2934,588,211,87,54,1262,5136
2022-04,7760 - Department of General Services,1112,190,97,82,75,398,1954
2022-04,7870 - California Victim Compensation Board,1,194,16,10,0,6,227
2022-04,7910 - Office of Administrative Law,0,9,4,5,3,0,21
2022-04,7920 - State Teachers' Retirement System,39,73,910,211,12,0,1245
2022-04,8120 - Commission on Peace Officer Standards and Training,0,0,1,122,2,1,126
2022-04,8140 - State Public Defender,42,4,9,14,2,10,81
2022-04,8560 - California Exposition and State Fair,0,1,0,1,0,0,2
2022-04,8570 - Department of Food and Agriculture,157,125,88,57,39,116,582
2022-04,8620 - Fair Political Practices Commission,79,2,0,0,0,1,82
2022-04,8660 - Public Utilities Commission,536,528,146,61,16,0,1287
2022-04,"8780 - Milton Marks ""Little Hoover"" Commission on California State Government Organization and Economy",7,0,0,0,0,0,7
2022-04,8825 - Commission on Asian and Pacific Islander American Affairs,3,0,0,0,0,0,3
2022-04,"8830 - Law Revision Commission, California",9,0,0,0,0,0,9
2022-04,8860 - Department of Finance,24,0,340,7,0,0,371
2022-04,8880 - Financial Information System for California,270,15,3,4,0,1,293
2022-04,"8885 - States Mandates, Commission on",8,2,0,1,0,0,11
2022-04,8940 - Military Department,6,12,39,22,2,2,83
2022-04,8955 - Department of Veterans Affairs,189,50,108,45,26,14,432
2022-04,A059 - California Correctional Health Care Services,410,186,251,173,223,0,1243
2022-04,A314 - California Science Center,2,0,0,24,2,3,31
2022-04,A341 - California Earthquake Authority,69,4,3,2,0,1,79
2022-04,A424 - Cradle-to-Career,3,0,3,0,0,0,6
2022-04,A541 - Board of Forestry and Fire Protection,5,3,2,0,0,0,10
2022-05,0500 - Governor's Office,20,18,22,28,14,18,120
2022-05,0509 - Governor's Office of Business and Economic Development (GO-Biz),89,21,3,3,4,7,127
2022-05,0511 - Secretary for Government Operations Agency,21,1,1,2,0,0,25
2022-05,"0515 - Secretary for Business, Consumer Services, and Housing Agency",39,11,2,4,0,2,58
2022-05,0521 - Secretary for Transportation Agency,0,19,0,2,0,1,22
2022-05,0531 - Office of Systems Integration,312,26,3,3,2,0,346
2022-05,0540 - Secretary of the Natural Resources Agency,68,0,11,1,4,2,86
2022-05,0552 - Office of the Inspector General,102,12,1,2,4,10,131
2022-05,0555 - Secretary for Environmental Protection,72,0,0,0,0,0,72
2022-05,0559 - Secretary for Labor and Workforce Development Agency,3,3,8,8,2,4,28
2022-05,0650 - Office of Planning and Research,98,25,25,2,0,0,150
2022-05,0690 - Governor's Office of Emergency Services,0,109,258,195,237,339,1138
2022-05,0820 - Department of Justice,1620,538,511,528,321,359,3877
2022-05,0845 - Department of Insurance,504,200,58,32,176,5,975
2022-05,0855 - California Gambling Control Commission,26,10,3,0,0,0,39
2022-05,0860 - State Board of Equalization,35,1,106,15,1,0,158
2022-05,0890 - Secretary of State,101,0,392,40,22,8,563
2022-05,1045 - Cannabis Control Appeals Panel,4,1,0,2,0,1,8
2022-05,1111 - Department of Consumer Affairs,545,451,415,404,296,254,2365
2022-05,1115 - Department of Cannabis Control,197,24,63,24,57,10,375
2022-05,1700 - California Civil Rights Department,191,36,21,3,2,5,258
2022-05,1701 - Department of Financial Protection and Innovation,543,67,36,34,4,2,686
2022-05,1703 - California Privacy Protection Agency,6,0,0,0,0,1,7
2022-05,1750 - California Horse Racing Board,11,2,8,1,4,1,27
2022-05,2100 - Department of Alcoholic Beverage Control,45,21,56,81,78,188,469
2022-05,2120 - Alcoholic Beverage Control Appeals Board,2,1,2,1,0,0,6
2022-05,2240 - Department of Housing and Community Development,615,76,96,92,13,96,988
2022-05,2320 - Department of Real Estate,23,123,126,22,14,21,329
2022-05,2600 - California Transportation Commission,23,2,8,2,1,1,37
2022-05,2660 - Department of Transportation,2086,2720,5580,1244,351,118,12099
2022-05,2665 - High-Speed Rail Authority,135,65,38,12,16,1,267
2022-05,2700 - California Traffic Safety Program,2,25,2,1,0,0,30
2022-05,2720 - California Highway Patrol,0,144,0,336,0,1004,1484
2022-05,3100 - Exposition Park,2,0,0,43,2,3,50
2022-05,3105 - California African-American Museum,0,0,0,18,0,0,18
2022-05,3125 - California Tahoe Conservancy,41,0,0,1,2,1,45
2022-05,3340 - California Conservation Corps,43,34,20,37,16,1,151
2022-05,3355 - Office of Energy Infrastructure Safety,50,0,0,0,0,1,51
2022-05,3360 - Energy Resources Conservation and Development Commission,574,47,23,10,6,1,661
2022-05,3480 - Department of Conservation,330,87,87,59,21,32,616
2022-05,3540 - Department of Forestry and Fire Protection,157,105,121,109,48,5,545
2022-05,3560 - State Lands Commission,115,14,29,5,5,2,170
2022-05,3600 - Department of Fish and Wildlife,1003,182,189,136,55,360,1925
2022-05,3640 - Wildlife Conservation Board,22,1,2,0,0,7,32
2022-05,3720 - California Coastal Commission,0,178,0,0,0,0,178
2022-05,3760 - State Coastal Conservancy,41,10,4,2,0,0,57
2022-05,3780 - Native American Heritage Commission,7,0,0,1,0,0,8
2022-05,3790 - Department of Parks and Recreation,264,205,96,190,120,201,1076
2022-05,3810 - Santa Monica Mountains Conservancy,7,0,0,0,0,0,7
2022-05,3820 - San Francisco Bay Conservation and Development Commission,47,0,0,0,0,0,47
2022-05,3825 - San Gabriel and Lower Los Angeles Rivers and Mountains Conservancy,1,8,1,0,0,0,10
2022-05,3830 - San Joaquin River Conservancy,2,1,0,0,0,0,3
2022-05,3835 - Baldwin Hills Conservancy,2,0,1,0,0,0,3
2022-05,3840 - Delta Protection Commission,5,0,0,1,1,0,7
2022-05,3845 - San Diego River Conservancy,0,0,0,0,0,3,3
2022-05,3850 - Coachella Valley Mountains Conservancy,0,0,2,1,1,0,4
2022-05,3855 - Sierra Nevada Conservancy,20,10,5,7,0,0,42
2022-05,3860 - Department of Water Resources,580,632,434,383,261,33,2323
2022-05,3862 - Central Valley Flood Protection Board,37,6,4,1,2,0,50
2022-05,3875 - Sacramento-San Joaquin Delta Conservancy,10,1,0,0,0,0,11
2022-05,3885 - Delta Stewardship Council,44,10,6,1,1,0,62
2022-05,3900 - State Air Resources Board,1130,221,114,38,36,14,1553
2022-05,3930 - Department of Pesticide Regulation,208,104,69,22,9,10,422
2022-05,3940 - State Water Resources Control Board,895,568,255,270,41,14,2043
2022-05,3960 - Department of Toxic Substances Control,406,181,91,108,37,192,1015
2022-05,3970 - Department of Resources Recycling and Recovery,483,105,100,31,16,10,745
2022-05,3980 - Office of Environmental Health Hazard Assessment,111,18,5,1,0,0,135
2022-05,4100 - State Council on Developmental Disabilities,30,6,13,6,6,5,66
2022-05,4140 - Department of Health Care Access and Information,190,49,17,113,17,76,462
2022-05,4150 - Department of Managed Health Care,474,5,3,0,0,2,484
2022-05,4170 - Department of Aging,170,9,9,4,2,6,200
2022-05,4250 - California Children and Families Commission,2,0,33,2,0,0,37
2022-05,4260 - State Department of Health Care Services,1652,915,272,228,70,698,3835
2022-05,4265 - Department of Public Health,2456,137,112,83,24,1126,3938
2022-05,4300 - Department of Developmental Services,376,88,39,28,9,23,563
2022-05,4440 - Department of State Hospitals,332,280,99,162,201,112,1186
2022-05,4700 - Department of Community Services and Development,100,3,5,2,1,2,113
2022-05,4800 - California Health Benefit Exchange,1159,62,55,33,13,40,1362
2022-05,5160 - Department of Rehabilitation,247,241,502,412,133,137,1672
2022-05,5175 - Department of Child Support Services,449,82,7,13,14,0,565
2022-05,5180 - Department of Social Services,2285,487,614,1377,388,0,5151
2022-05,5225 - Department of Corrections and Rehabilitation,1577,303,562,555,263,0,3260
2022-05,5227 - Board of State and Community Corrections,108,2,0,1,3,0,114
2022-05,5420 - Prison Industry Authority,42,46,99,48,6,3,244
2022-05,6120 - California State Library,53,20,16,28,24,4,145
2022-05,6125 - Education Audit Appeals Panel,0,2,1,0,0,0,3
2022-05,6250 - California School for the Deaf - Riverside,0,2,1,10,0,6,19
2022-05,6360 - Commission on Teacher Credentialing,77,39,14,8,2,6,146
2022-05,6870 - Board of Governors of the California Community Colleges,161,1,4,1,0,0,167
2022-05,"6980 - Student Aid Commission, California",90,21,10,1,1,5,128
2022-05,7100 - Employment Development Department,6752,0,749,412,0,0,7913
2022-05,7300 - Agricultural Labor Relations Board,10,6,36,4,1,4,61
2022-05,7320 - Public Employment Relations Board,8,26,18,6,3,3,64
2022-05,7501 - Department of Human Resources,139,57,56,16,6,13,287
2022-05,7502 - California Department of Technology,769,47,30,7,7,62,922
2022-05,7503 - State Personnel Board,58,12,3,0,1,0,74
2022-05,7504 - Office of Data and Innovation,22,0,0,0,0,0,22
2022-05,7600 - California Department of Tax and Fee Administration,2534,556,349,109,13,8,3569
2022-05,7730 - Franchise Tax Board,151,138,3072,1055,95,550,5061
2022-05,7760 - Department of General Services,1129,164,104,80,70,401,1948
2022-05,7870 - California Victim Compensation Board,1,199,16,10,0,5,231
2022-05,7910 - Office of Administrative Law,0,9,4,5,3,0,21
2022-05,7920 - State Teachers' Retirement System,39,72,909,212,12,0,1244
2022-05,8120 - Commission on Peace Officer Standards and Training,0,1,0,126,1,1,129
2022-05,8140 - State Public Defender,41,4,10,13,2,8,78
2022-05,8560 - California Exposition and State Fair,0,1,0,1,0,0,2
2022-05,8570 - Department of Food and Agriculture,176,109,83,73,44,116,601
2022-05,8620 - Fair Political Practices Commission,79,2,0,0,0,1,82
2022-05,8660 - Public Utilities Commission,536,528,146,61,16,0,1287
2022-05,"8780 - Milton Marks ""Little Hoover"" Commission on California State Government Organization and Economy",7,0,0,0,0,0,7
2022-05,8825 - Commission on Asian and Pacific Islander American Affairs,3,0,0,0,0,0,3
2022-05,"8830 - Law Revision Commission, California",9,0,0,0,0,0,9
2022-05,8860 - Department of Finance,24,0,354,6,0,0,384
2022-05,8880 - Financial Information System for California,1,292,0,0,0,0,293
2022-05,"8885 - States Mandates, Commission on",9,2,0,1,0,0,12
2022-05,8940 - Military Department,6,12,39,22,2,2,83
2022-05,8955 - Department of Veterans Affairs,189,50,108,45,26,14,432
2022-05,A059 - California Correctional Health Care Services,828,266,504,323,260,2,2183
2022-05,A314 - California Science Center,2,0,0,25,2,2,31
2022-05,A341 - California Earthquake Authority,68,4,2,3,0,1,78
2022-05,A424 - Cradle-to-Career,3,0,3,0,0,0,6
2022-05,A541 - Board of Forestry and Fire Protection,5,4,2,1,0,0,12
2022-06,0500 - Governor's Office,20,18,27,27,13,16,121
2022-06,0509 - Governor's Office of Business and Economic Development (GO-Biz),90,9,8,4,7,1,119
2022-06,0511 - Secretary for Government Operations Agency,22,1,3,0,0,0,26
2022-06,"0515 - Secretary for Business, Consumer Services, and Housing Agency",32,10,5,6,0,2,55
2022-06,0521 - Secretary for Transportation Agency,1,0,15,2,0,0,18
2022-06,0531 - Office of Systems Integration,320,15,7,1,2,6,351
2022-06,0540 - Secretary of the Natural Resources Agency,64,0,11,1,5,1,82
2022-06,0552 - Office of the Inspector General,96,17,3,1,2,7,126
2022-06,0555 - Secretary for Environmental Protection,72,0,0,0,0,0,72
2022-06,0559 - Secretary for Labor and Workforce Development Agency,3,3,8,8,2,4,28
2022-06,0650 - Office of Planning and Research,111,25,23,2,0,1,162
2022-06,0690 - Governor's Office of Emergency Services,30,238,171,212,185,0,836
2022-06,0820 - Department of Justice,1620,538,511,528,321,359,3877
2022-06,0845 - Department of Insurance,505,202,58,32,177,5,979
2022-06,0855 - California Gambling Control Commission,22,7,7,0,0,2,38
2022-06,0860 - State Board of Equalization,28,2,112,15,1,3,161
2022-06,0890 - Secretary of State,101,0,392,40,22,8,563
2022-06,0911 - Citizens Redistricting Commission,4,1,2,0,0,0,7
2022-06,1045 - Cannabis Control Appeals Panel,4,1,0,2,0,1,8
2022-06,1111 - Department of Consumer Affairs,430,434,332,328,261,227,2012
2022-06,1115 - Department of Cannabis Control,192,26,40,19,56,2,335
2022-06,1700 - California Civil Rights Department,196,34,21,3,1,5,260
2022-06,1701 - Department of Financial Protection and Innovation,562,55,20,32,5,0,674
2022-06,1703 - California Privacy Protection Agency,7,0,0,0,0,1,8
2022-06,1750 - California Horse Racing Board,11,2,8,1,4,1,27
2022-06,2100 - Department of Alcoholic Beverage Control,47,24,58,90,87,177,483
2022-06,2120 - Alcoholic Beverage Control Appeals Board,2,1,2,1,0,0,6
2022-06,2240 - Department of Housing and Community Development,611,76,97,93,12,93,982
2022-06,2320 - Department of Real Estate,24,123,126,21,14,22,330
2022-06,2600 - California Transportation Commission,24,2,8,2,1,0,37
2022-06,2660 - Department of Transportation,2086,2720,5580,1244,351,118,12099
2022-06,2665 - High-Speed Rail Authority,169,48,24,14,9,3,267
2022-06,2700 - California Traffic Safety Program,1,27,1,0,0,0,29
2022-06,2720 - California Highway Patrol,0,142,0,334,0,1004,1480
2022-06,3100 - Exposition Park,2,0,0,27,2,2,33
2022-06,3105 - California African-American Museum,0,0,0,18,0,0,18
2022-06,3125 - California Tahoe Conservancy,18,4,6,11,1,6,46
2022-06,3340 - California Conservation Corps,44,29,23,29,18,0,143
2022-06,3355 - Office of Energy Infrastructure Safety,47,0,0,0,0,1,48
2022-06,3360 - Energy Resources Conservation and Development Commission,580,48,24,11,5,1,669
2022-06,3480 - Department of Conservation,393,51,91,60,10,29,634
2022-06,3540 - Department of Forestry and Fire Protection,175,116,135,123,51,5,605
2022-06,3560 - State Lands Commission,114,14,29,4,5,2,168
2022-06,3600 - Department of Fish and Wildlife,1004,181,187,129,54,340,1895
2022-06,3640 - Wildlife Conservation Board,20,1,2,0,0,7,30
2022-06,3720 - California Coastal Commission,48,57,38,8,6,2,159
2022-06,3760 - State Coastal Conservancy,42,10,4,2,0,0,58
2022-06,3780 - Native American Heritage Commission,7,0,0,1,0,0,8
2022-06,3790 - Department of Parks and Recreation,311,199,108,155,101,221,1095
2022-06,3810 - Santa Monica Mountains Conservancy,6,0,0,0,0,0,6
2022-06,3820 - San Francisco Bay Conservation and Development Commission,47,0,0,0,0,0,47
2022-06,3825 - San Gabriel and Lower Los Angeles Rivers and Mountains Conservancy,1,8,1,0,0,0,10
2022-06,3830 - San Joaquin River Conservancy,2,1,0,0,0,0,3
2022-06,3835 - Baldwin Hills Conservancy,1,1,1,0,0,0,3
2022-06,3840 - Delta Protection Commission,4,0,0,1,1,0,6
2022-06,3845 - San Diego River Conservancy,0,0,0,0,0,3,3
2022-06,3850 - Coachella Valley Mountains Conservancy,0,0,1,1,1,0,3
2022-06,3855 - Sierra Nevada Conservancy,21,9,7,6,0,0,43
2022-06,3860 - Department of Water Resources,185,347,854,512,96,22,2016
2022-06,3862 - Central Valley Flood Protection Board,21,16,5,2,6,0,50
2022-06,3875 - Sacramento-San Joaquin Delta Conservancy,7,3,1,0,0,0,11
2022-06,3885 - Delta Stewardship Council,45,10,6,1,1,0,63
2022-06,3900 - State Air Resources Board,73,618,496,207,130,37,1561
2022-06,3930 - Department of Pesticide Regulation,188,97,89,25,6,3,408
2022-06,3940 - State Water Resources Control Board,910,566,246,285,40,17,2064
2022-06,3960 - Department of Toxic Substances Control,378,231,118,58,31,212,1028
2022-06,3970 - Department of Resources Recycling and Recovery,445,88,46,27,13,1,620
2022-06,3980 - Office of Environmental Health Hazard Assessment,109,20,5,1,0,0,135
2022-06,4100 - State Council on Developmental Disabilities,30,6,13,6,6,5,66
2022-06,4140 - Department of Health Care Access and Information,192,49,21,115,20,70,467
2022-06,4150 - Department of Managed Health Care,451,5,5,0,0,63,524
2022-06,4170 - Department of Aging,173,14,7,8,1,5,208
2022-06,4250 - California Children and Families Commission,1,0,35,2,0,0,38
2022-06,4260 - State Department of Health Care Services,1739,889,265,211,63,631,3798
2022-06,4265 - Department of Public Health,2456,137,112,83,24,1126,3938
2022-06,4300 - Department of Developmental Services,382,92,41,29,10,24,578
2022-06,4440 - Department of State Hospitals,327,274,77,154,183,0,1015
2022-06,4560 - Mental Health Services Oversight and Accountability Commission,7,15,10,8,3,7,50
2022-06,4700 - Department of Community Services and Development,101,3,6,3,2,2,117
2022-06,4800 - California Health Benefit Exchange,1159,62,55,35,9,43,1363
2022-06,5160 - Department of Rehabilitation,244,228,506,391,134,142,1645
2022-06,5175 - Department of Child Support Services,426,89,7,12,12,0,546
2022-06,5180 - Department of Social Services,1566,403,494,1179,359,0,4001
2022-06,5225 - Department of Corrections and Rehabilitation,185,34,75,78,35,0,407
2022-06,5227 - Board of State and Community Corrections,17,93,2,1,2,1,116
2022-06,5420 - Prison Industry Authority,6,41,101,49,4,17,218
2022-06,6120 - California State Library,52,21,16,27,23,4,143
2022-06,6125 - Education Audit Appeals Panel,0,2,1,0,0,0,3
2022-06,6250 - California School for the Deaf - Riverside,0,2,1,9,0,5,17
2022-06,6360 - Commission on Teacher Credentialing,73,35,20,10,6,19,163
2022-06,6870 - Board of Governors of the California Community Colleges,168,3,5,1,0,0,177
2022-06,"6980 - Student Aid Commission, California",90,21,10,1,1,5,128
2022-06,7100 - Employment Development Department,6667,0,716,409,0,0,7792
2022-06,7300 - Agricultural Labor Relations Board,10,6,34,5,1,4,60
2022-06,7320 - Public Employment Relations Board,8,25,18,6,3,2,62
2022-06,7501 - Department of Human Resources,135,35,60,16,3,6,255
2022-06,7502 - California Department of Technology,772,48,30,7,6,64,927
2022-06,7503 - State Personnel Board,53,16,3,0,0,1,73
2022-06,7504 - Office of Data and Innovation,21,0,0,0,0,0,21
2022-06,7600 - California Department of Tax and Fee Administration,2538,576,347,108,15,14,3598
2022-06,7730 - Franchise Tax Board,180,208,3225,995,115,471,5194
2022-06,7760 - Department of General Services,982,174,101,72,69,363,1761
2022-06,7870 - California Victim Compensation Board,1,198,16,10,0,2,227
2022-06,7910 - Office of Administrative Law,2,7,6,6,2,0,23
2022-06,7920 - State Teachers' Retirement System,39,71,912,211,12,0,1245
2022-06,8120 - Commission on Peace Officer Standards and Training,2,0,0,115,0,5,122
2022-06,8140 - State Public Defender,43,4,9,15,2,11,84
2022-06,8560 - California Exposition and State Fair,0,0,0,0,0,0,0
2022-06,8570 - Department of Food and Agriculture,185,146,96,77,40,121,665
2022-06,8620 - Fair Political Practices Commission,79,2,0,0,0,1,82
2022-06,8660 - Public Utilities Commission,1047,35,20,14,4,10,1130
2022-06,"8780 - Milton Marks ""Little Hoover"" Commission on California State Government Organization and Economy",7,0,0,0,0,0,7
2022-06,8825 - Commission on Asian and Pacific Islander American Affairs,3,0,0,0,0,0,3
2022-06,"8830 - Law Revision Commission, California",8,0,0,0,0,0,8
2022-06,8860 - Department of Finance,38,28,278,30,8,7,389
2022-06,8880 - Financial Information System for California,1,273,15,0,0,2,291
2022-06,"8885 - States Mandates, Commission on",9,2,0,1,0,0,12
2022-06,8940 - Military Department,6,12,40,22,2,2,84
2022-06,8955 - Department of Veterans Affairs,124,91,126,59,23,30,453
2022-06,A059 - California Correctional Health Care Services,906,300,538,382,328,13,2467
2022-06,A314 - California Science Center,2,0,0,26,2,2,32
2022-06,A341 - California Earthquake Authority,66,4,2,3,0,1,76
2022-06,A424 - Cradle-to-Career,3,0,3,0,0,0,6
2022-06,A541 - Board of Forestry and Fire Protection,5,3,3,1,0,0,12
2022-07,0500 - Governor's Office,23,17,29,29,15,17,130
2022-07,0509 - Governor's Office of Business and Economic Development (GO-Biz),88,9,10,4,7,1,119
2022-07,0511 - Secretary for Government Operations Agency,5,6,9,0,0,0,20
2022-07,"0515 - Secretary for Business, Consumer Services, and Housing Agency",35,10,5,6,0,2,58
2022-07,0521 - Secretary for Transportation Agency,1,0,15,2,0,0,18
2022-07,0531 - Office of Systems Integration,316,15,7,1,2,6,347
2022-07,0540 - Secretary of the Natural Resources Agency,71,0,10,1,2,1,85
2022-07,0552 - Office of the Inspector General,103,6,3,3,2,9,126
2022-07,0555 - Secretary for Environmental Protection,72,0,0,0,0,0,72
2022-07,0559 - Secretary for Labor and Workforce Development Agency,3,3,8,8,2,4,28
2022-07,0650 - Office of Planning and Research,85,32,22,11,0,1,151
2022-07,0690 - Governor's Office of Emergency Services,230,168,174,187,117,448,1324
2022-07,0820 - Department of Justice,1021,350,321,322,195,399,2608
2022-07,0845 - Department of Insurance,509,202,59,33,176,5,984
2022-07,0855 - California Gambling Control Commission,22,7,7,0,0,2,38
2022-07,0860 - State Board of Equalization,27,2,114,16,1,1,161
2022-07,0890 - Secretary of State,101,0,390,40,22,8,561
2022-07,0911 - Citizens Redistricting Commission,4,1,2,0,0,0,7
2022-07,1045 - Cannabis Control Appeals Panel,4,1,0,2,0,1,8
2022-07,1111 - Department of Consumer Affairs,430,434,332,328,261,227,2012
2022-07,1115 - Department of Cannabis Control,196,31,41,12,64,3,347
2022-07,1700 - California Civil Rights Department,205,36,21,3,1,5,271
2022-07,1701 - Department of Financial Protection and Innovation,563,58,21,32,7,1,682
2022-07,1703 - California Privacy Protection Agency,7,0,0,0,0,1,8
2022-07,1750 - California Horse Racing Board,11,2,9,1,4,1,28
2022-07,2100 - Department of Alcoholic Beverage Control,48,25,61,92,95,164,485
2022-07,2120 - Alcoholic Beverage Control Appeals Board,2,1,2,1,0,0,6
2022-07,2240 - Department of Housing and Community Development,632,82,96,99,15,94,1018
2022-07,2320 - Department of Real Estate,24,80,155,29,15,4,307
2022-07,2600 - California Transportation Commission,23,2,8,2,1,0,36
2022-07,2660 - Department of Transportation,2086,2720,5580,1244,351,118,12099
2022-07,2665 - High-Speed Rail Authority,181,55,29,21,26,4,316
2022-07,2700 - California Traffic Safety Program,1,27,1,0,0,0,29
2022-07,2720 - California Highway Patrol,0,137,0,329,0,1008,1474
2022-07,3100 - Exposition Park,2,0,0,27,2,2,33
2022-07,3105 - California African-American Museum,0,0,0,18,0,0,18
2022-07,3125 - California Tahoe Conservancy,18,4,6,11,1,6,46
2022-07,3340 - California Conservation Corps,41,30,25,23,19,1,139
2022-07,3355 - Office of Energy Infrastructure Safety,47,0,0,0,0,2,49
2022-07,3360 - Energy Resources Conservation and Development Commission,584,47,24,11,5,1,672
2022-07,3480 - Department of Conservation,393,52,90,61,10,29,635
2022-07,3540 - Department of Forestry and Fire Protection,171,113,132,122,51,6,595
2022-07,3560 - State Lands Commission,94,26,17,13,6,2,158
2022-07,3600 - Department of Fish and Wildlife,1011,188,176,159,62,322,1918
2022-07,3640 - Wildlife Conservation Board,22,1,2,0,0,4,29
2022-07,3720 - California Coastal Commission,47,60,39,8,6,2,162
2022-07,3760 - State Coastal Conservancy,43,15,2,2,0,0,62
2022-07,3780 - Native American Heritage Commission,7,0,0,1,0,0,8
2022-07,3790 - Department of Parks and Recreation,261,175,105,135,39,220,935
2022-07,3810 - Santa Monica Mountains Conservancy,7,0,0,0,0,0,7
2022-07,3820 - San Francisco Bay Conservation and Development Commission,47,0,0,0,0,0,47
2022-07,3825 - San Gabriel and Lower Los Angeles Rivers and Mountains Conservancy,1,8,1,0,0,0,10
2022-07,3830 - San Joaquin River Conservancy,2,1,0,0,0,0,3
2022-07,3835 - Baldwin Hills Conservancy,1,1,1,0,0,0,3
2022-07,3840 - Delta Protection Commission,3,0,0,1,1,0,5
2022-07,3845 - San Diego River Conservancy,0,0,0,0,0,3,3
2022-07,3850 - Coachella Valley Mountains Conservancy,0,0,1,1,1,0,3
2022-07,3855 - Sierra Nevada Conservancy,19,10,9,7,0,0,45
2022-07,3860 - Department of Water Resources,196,367,887,575,110,22,2157
2022-07,3862 - Central Valley Flood Protection Board,21,15,7,2,6,0,51
2022-07,3875 - Sacramento-San Joaquin Delta Conservancy,5,8,0,1,0,0,14
2022-07,3885 - Delta Stewardship Council,45,10,6,1,1,0,63
2022-07,3900 - State Air Resources Board,1253,221,114,38,36,14,1676
2022-07,3930 - Department of Pesticide Regulation,193,99,93,25,6,5,421
2022-07,3940 - State Water Resources Control Board,919,578,249,295,40,17,2098
2022-07,3960 - Department of Toxic Substances Control,238,328,166,84,40,189,1045
2022-07,3970 - Department of Resources Recycling and Recovery,422,91,44,28,18,1,604
2022-07,3980 - Office of Environmental Health Hazard Assessment,109,20,5,1,0,0,135
2022-07,4100 - State Council on Developmental Disabilities,30,4,12,5,6,3,60
2022-07,4140 - Department of Health Care Access and Information,187,53,22,115,20,68,465
2022-07,4150 - Department of Managed Health Care,600,5,12,0,0,0,617
2022-07,4170 - Department of Aging,177,13,10,9,1,3,213
2022-07,4250 - California Children and Families Commission,1,0,35,2,0,0,38
2022-07,4260 - State Department of Health Care Services,1811,941,278,201,65,517,3813
2022-07,4265 - Department of Public Health,2456,137,112,83,24,1126,3938
2022-07,4300 - Department of Developmental Services,379,93,46,29,11,21,579
2022-07,4440 - Department of State Hospitals,331,272,116,162,282,1,1164
2022-07,4560 - Mental Health Services Oversight and Accountability Commission,7,15,10,8,3,7,50
2022-07,4700 - Department of Community Services and Development,107,3,4,2,0,2,118
2022-07,4800 - California Health Benefit Exchange,1179,66,51,35,12,39,1382
2022-07,5160 - Department of Rehabilitation,243,231,503,390,134,149,1650
2022-07,5175 - Department of Child Support Services,437,90,11,12,12,0,562
2022-07,5180 - Department of Social Services,1566,403,494,1179,359,0,4001
2022-07,5225 - Department of Corrections and Rehabilitation,185,34,75,78,35,0,407
2022-07,5227 - Board of State and Community Corrections,11,87,8,1,1,9,117
2022-07,5420 - Prison Industry Authority,6,41,100,48,4,20,219
2022-07,6120 - California State Library,54,21,16,27,22,3,143
2022-07,6125 - Education Audit Appeals Panel,0,2,1,0,0,0,3
2022-07,6250 - California School for the Deaf - Riverside,0,2,1,9,0,5,17
2022-07,6360 - Commission on Teacher Credentialing,65,36,19,12,7,20,159
2022-07,6870 - Board of Governors of the California Community Colleges,164,3,5,1,0,0,173
2022-07,"6980 - Student Aid Commission, California",90,21,10,1,1,5,128
2022-07,7100 - Employment Development Department,6144,0,1632,555,0,0,8331
2022-07,7300 - Agricultural Labor Relations Board,8,6,32,5,0,5,56
2022-07,7320 - Public Employment Relations Board,8,25,18,6,3,2,62
2022-07,7501 - Department of Human Resources,137,52,64,16,3,7,279
2022-07,7502 - California Department of Technology,767,47,31,7,6,63,921
2022-07,7503 - State Personnel Board,57,14,1,0,2,0,74
2022-07,7504 - Office of Data and Innovation,24,0,0,0,0,0,24
2022-07,7600 - California Department of Tax and Fee Administration,2500,592,354,107,14,15,3582
2022-07,7730 - Franchise Tax Board,186,229,3237,970,115,469,5206
2022-07,7760 - Department of General Services,979,190,123,108,84,339,1823
2022-07,7870 - California Victim Compensation Board,1,195,15,13,0,2,226
2022-07,7910 - Office of Administrative Law,2,7,6,6,2,0,23
2022-07,7920 - State Teachers' Retirement System,3,36,951,230,8,22,1250
2022-07,8120 - Commission on Peace Officer Standards and Training,2,0,0,117,0,5,124
2022-07,8140 - State Public Defender,43,4,10,14,2,11,84
2022-07,8560 - California Exposition and State Fair,0,0,0,0,0,0,0
2022-07,8570 - Department of Food and Agriculture,172,130,93,63,35,96,589
2022-07,8620 - Fair Political Practices Commission,55,16,8,2,0,1,82
2022-07,8660 - Public Utilities Commission,1047,35,20,14,4,10,1130
2022-07,"8780 - Milton Marks ""Little Hoover"" Commission on California State Government Organization and Economy",5,0,1,0,0,0,6
2022-07,8825 - Commission on Asian and Pacific Islander American Affairs,3,0,0,0,0,0,3
2022-07,"8830 - Law Revision Commission, California",8,0,0,0,0,0,8
2022-07,8860 - Department of Finance,38,28,275,29,8,7,385
2022-07,8880 - Financial Information System for California,273,8,2,6,0,1,290
2022-07,"8885 - States Mandates, Commission on",9,2,0,1,0,0,12
2022-07,8940 - Military Department,6,12,41,24,2,3,88
2022-07,8955 - Department of Veterans Affairs,124,91,126,58,23,30,452
2022-07,A059 - California Correctional Health Care Services,940,302,540,376,353,2,2513
2022-07,A314 - California Science Center,2,0,0,26,2,2,32
2022-07,A341 - California Earthquake Authority,64,5,3,2,0,1,75
2022-07,A424 - Cradle-to-Career,3,0,4,0,0,0,7
2022-07,A541 - Board of Forestry and Fire Protection,3,3,3,1,0,0,10
2022-08,0500 - Governor's Office,22,17,30,29,15,19,132
2022-08,0509 - Governor's Office of Business and Economic Development (GO-Biz),97,10,12,4,7,1,131
2022-08,0511 - Secretary for Government Operations Agency,5,6,9,0,0,0,20
2022-08,"0515 - Secretary for Business, Consumer Services, and Housing Agency",36,10,5,6,0,2,59
2022-08,0521 - Secretary for Transportation Agency,0,0,15,2,0,0,17
2022-08,0531 - Office of Systems Integration,320,15,7,1,2,6,351
2022-08,0540 - Secretary of the Natural Resources Agency,72,0,10,1,2,1,86
2022-08,0552 - Office of the Inspector General,101,7,5,2,7,9,131
2022-08,0555 - Secretary for Environmental Protection,72,0,0,0,0,0,72
2022-08,0559 - Secretary for Labor and Workforce Development Agency,3,3,8,8,2,4,28
2022-08,0650 - Office of Planning and Research,93,33,22,11,0,1,160
2022-08,0690 - Governor's Office of Emergency Services,62,159,169,181,153,221,945
2022-08,0820 - Department of Justice,1708,586,562,538,321,366,4081
2022-08,0840 - State Controller,695,148,118,79,35,65,1140
2022-08,0845 - Department of Insurance,476,83,28,19,119,2,727
2022-08,0855 - California Gambling Control Commission,22,8,7,0,0,2,39
2022-08,0860 - State Board of Equalization,27,2,116,15,1,1,162
2022-08,0890 - Secretary of State,91,38,364,33,18,17,561
2022-08,0911 - Citizens Redistricting Commission,5,1,2,0,0,0,8
2022-08,1045 - Cannabis Control Appeals Panel,4,1,0,2,0,1,8
2022-08,1111 - Department of Consumer Affairs,444,442,339,330,266,226,2047
2022-08,1115 - Department of Cannabis Control,200,28,42,15,65,0,350
2022-08,1700 - California Civil Rights Department,209,37,20,3,1,6,276
2022-08,1701 - Department of Financial Protection and Innovation,559,59,22,34,6,0,680
2022-08,1703 - California Privacy Protection Agency,11,0,0,0,0,1,12
2022-08,1750 - California Horse Racing Board,11,2,8,1,4,1,27
2022-08,2100 - Department of Alcoholic Beverage Control,48,27,56,93,102,160,486
2022-08,2120 - Alcoholic Beverage Control Appeals Board,2,1,2,1,0,0,6
2022-08,2240 - Department of Housing and Community Development,636,86,98,96,16,90,1022
2022-08,2320 - Department of Real Estate,21,80,104,22,15,3,245
2022-08,2600 - California Transportation Commission,23,2,8,2,1,0,36
2022-08,2660 - Department of Transportation,2236,2936,5923,1311,383,126,12915
2022-08,2665 - High-Speed Rail Authority,189,58,30,23,28,5,333
2022-08,2700 - California Traffic Safety Program,1,26,1,0,0,0,28
2022-08,2720 - California Highway Patrol,0,130,0,321,0,1013,1464
2022-08,3100 - Exposition Park,0,0,0,7,0,0,7
2022-08,3105 - California African-American Museum,0,0,0,0,18,0,18
2022-08,3125 - California Tahoe Conservancy,18,4,6,11,1,6,46
2022-08,3340 - California Conservation Corps,43,31,25,25,19,0,143
2022-08,3355 - Office of Energy Infrastructure Safety,51,0,0,0,0,2,53
2022-08,3360 - Energy Resources Conservation and Development Commission,585,46,24,11,5,1,672
2022-08,3480 - Department of Conservation,389,56,91,60,10,32,638
2022-08,3540 - Department of Forestry and Fire Protection,176,120,141,128,52,5,622
2022-08,3560 - State Lands Commission,93,26,17,13,6,2,157
2022-08,3600 - Department of Fish and Wildlife,895,254,204,180,61,339,1933
2022-08,3640 - Wildlife Conservation Board,22,1,2,0,0,5,30
2022-08,3720 - California Coastal Commission,48,60,40,8,6,2,164
2022-08,3760 - State Coastal Conservancy,43,15,2,2,0,0,62
2022-08,3780 - Native American Heritage Commission,7,0,0,1,0,0,8
2022-08,3790 - Department of Parks and Recreation,236,183,146,135,42,220,962
2022-08,3810 - Santa Monica Mountains Conservancy,6,0,0,0,0,0,6
2022-08,3820 - San Francisco Bay Conservation and Development Commission,47,0,0,0,0,0,47
2022-08,3825 - San Gabriel and Lower Los Angeles Rivers and Mountains Conservancy,1,8,1,0,0,0,10
2022-08,3830 - San Joaquin River Conservancy,2,1,0,0,0,0,3
2022-08,3835 - Baldwin Hills Conservancy,1,1,1,0,0,0,3
2022-08,3840 - Delta Protection Commission,3,0,1,0,1,1,6
2022-08,3845 - San Diego River Conservancy,0,0,0,0,0,3,3
2022-08,3850 - Coachella Valley Mountains Conservancy,0,0,1,1,2,0,4
2022-08,3855 - Sierra Nevada Conservancy,19,11,7,8,0,0,45
2022-08,3860 - Department of Water Resources,177,367,913,588,107,27,2179
2022-08,3862 - Central Valley Flood Protection Board,21,15,7,2,6,0,51
2022-08,3875 - Sacramento-San Joaquin Delta Conservancy,11,1,0,1,0,0,13
2022-08,3885 - Delta Stewardship Council,46,10,6,1,1,0,64
2022-08,3900 - State Air Resources Board,196,618,496,207,130,37,1684
2022-08,3930 - Department of Pesticide Regulation,193,96,93,29,7,1,419
2022-08,3940 - State Water Resources Control Board,930,589,254,302,41,21,2137
2022-08,3960 - Department of Toxic Substances Control,608,135,78,98,32,9,960
2022-08,3970 - Department of Resources Recycling and Recovery,433,96,49,23,14,1,616
2022-08,3980 - Office of Environmental Health Hazard Assessment,109,20,5,1,0,0,135
2022-08,4100 - State Council on Developmental Disabilities,30,4,12,5,6,3,60
2022-08,4140 - Department of Health Care Access and Information,191,50,20,115,20,67,463
2022-08,4150 - Department of Managed Health Care,604,5,12,0,0,0,621
2022-08,4170 - Department of Aging,184,13,10,9,1,3,220
2022-08,4250 - California Children and Families Commission,1,0,36,2,0,0,39
2022-08,4260 - State Department of Health Care Services,1690,781,242,117,34,1106,3970
2022-08,4265 - Department of Public Health,2456,137,112,83,24,1126,3938
2022-08,4300 - Department of Developmental Services,375,95,49,34,7,24,584
2022-08,4440 - Department of State Hospitals,340,275,118,165,323,1,1222
2022-08,4560 - Mental Health Services Oversight and Accountability Commission,7,15,10,8,3,7,50
2022-08,4700 - Department of Community Services and Development,112,3,4,2,0,2,123
2022-08,4800 - California Health Benefit Exchange,1197,68,55,33,12,35,1400
2022-08,5160 - Department of Rehabilitation,243,231,502,391,134,146,1647
2022-08,5175 - Department of Child Support Services,444,92,10,12,12,0,570
2022-08,5180 - Department of Social Services,1566,403,494,1179,359,0,4001
2022-08,5225 - Department of Corrections and Rehabilitation,1908,404,697,816,491,1050,5366
2022-08,5227 - Board of State and Community Corrections,11,88,8,1,1,9,118
2022-08,5420 - Prison Industry Authority,6,41,100,48,4,20,219
2022-08,6120 - California State Library,55,21,16,27,22,3,144
2022-08,6125 - Education Audit Appeals Panel,0,2,1,0,0,0,3
2022-08,6250 - California School for the Deaf - Riverside,0,2,1,9,0,5,17
2022-08,6360 - Commission on Teacher Credentialing,65,36,19,12,7,20,159
2022-08,6870 - Board of Governors of the California Community Colleges,167,3,6,1,0,0,177
2022-08,"6980 - Student Aid Commission, California",90,21,10,1,1,5,128
2022-08,7100 - Employment Development Department,5695,0,1617,419,0,0,7731
2022-08,7120 - California Workforce Development Board,74,1,0,0,0,0,75
2022-08,7300 - Agricultural Labor Relations Board,8,6,32,6,0,5,57
2022-08,7320 - Public Employment Relations Board,8,26,19,5,3,2,63
2022-08,7501 - Department of Human Resources,137,53,64,16,3,8,281
2022-08,7502 - California Department of Technology,767,47,33,8,6,62,923
2022-08,7503 - State Personnel Board,55,13,3,0,1,0,72
2022-08,7504 - Office of Data and Innovation,27,0,0,0,0,0,27
2022-08,7600 - California Department of Tax and Fee Administration,2491,602,361,106,16,15,3591
2022-08,7730 - Franchise Tax Board,188,259,3280,943,130,379,5179
2022-08,7760 - Department of General Services,784,181,193,267,57,386,1868
2022-08,7870 - California Victim Compensation Board,1,195,15,12,0,1,224
2022-08,7910 - Office of Administrative Law,2,7,6,6,2,0,23
2022-08,7920 - State Teachers' Retirement System,3,36,948,231,8,14,1240
2022-08,8120 - Commission on Peace Officer Standards and Training,2,0,0,124,0,5,131
2022-08,8140 - State Public Defender,43,4,11,13,2,11,84
2022-08,8560 - California Exposition and State Fair,0,0,0,0,0,0,0
2022-08,8570 - Department of Food and Agriculture,104,64,43,28,24,47,310
2022-08,8620 - Fair Political Practices Commission,57,16,9,2,0,1,85
2022-08,8660 - Public Utilities Commission,1151,59,46,23,9,11,1299
2022-08,"8780 - Milton Marks ""Little Hoover"" Commission on California State Government Organization and Economy",3,0,3,0,0,0,6
2022-08,8825 - Commission on Asian and Pacific Islander American Affairs,3,0,0,0,0,0,3
2022-08,"8830 - Law Revision Commission, California",8,0,0,0,0,0,8
2022-08,8860 - Department of Finance,38,28,274,31,7,10,388
2022-08,8880 - Financial Information System for California,268,10,5,4,1,1,289
2022-08,"8885 - States Mandates, Commission on",10,2,0,1,0,0,13
2022-08,8940 - Military Department,6,12,41,24,2,3,88
2022-08,8955 - Department of Veterans Affairs,124,92,128,60,22,28,454
2022-08,A059 - California Correctional Health Care Services,955,309,533,474,373,3,2647
2022-08,A314 - California Science Center,2,0,0,26,3,2,33
2022-08,A341 - California Earthquake Authority,63,5,2,3,0,1,74
2022-08,A424 - Cradle-to-Career,6,0,4,0,0,0,10
2022-08,A541 - Board of Forestry and Fire Protection,3,3,3,1,0,0,10
2022-09,0500 - Governor's Office,20,21,30,29,11,24,135
2022-09,0509 - Governor's Office of Business and Economic Development (GO-Biz),98,10,15,5,6,0,134
2022-09,0511 - Secretary for Government Operations Agency,6,10,7,1,0,0,24
2022-09,"0515 - Secretary for Business, Consumer Services, and Housing Agency",36,10,5,6,0,2,59
2022-09,0521 - Secretary for Transportation Agency,0,0,15,2,0,0,17
2022-09,0531 - Office of Systems Integration,322,16,7,1,2,5,353
2022-09,0540 - Secretary of the Natural Resources Agency,73,0,10,1,2,1,87
2022-09,0552 - Office of the Inspector General,103,7,5,2,7,9,133
2022-09,0555 - Secretary for Environmental Protection,72,0,0,0,0,0,72
2022-09,0559 - Secretary for Labor and Workforce Development Agency,3,3,8,8,2,4,28
2022-09,0650 - Office of Planning and Research,93,33,22,11,0,1,160
2022-09,0690 - Governor's Office of Emergency Services,31,223,181,200,170,472,1277
2022-09,0820 - Department of Justice,1723,595,565,557,325,369,4134
2022-09,0840 - State Controller,694,148,118,78,35,64,1137
2022-09,0845 - Department of Insurance,476,83,28,19,119,2,727
2022-09,0855 - California Gambling Control Commission,24,8,7,0,0,0,39
2022-09,0860 - State Board of Equalization,26,2,111,15,1,1,156
2022-09,0890 - Secretary of State,90,38,356,33,21,23,561
2022-09,0911 - Citizens Redistricting Commission,5,1,2,0,0,0,8
2022-09,1045 - Cannabis Control Appeals Panel,5,1,0,1,0,1,8
2022-09,1111 - Department of Consumer Affairs,567,511,403,393,276,251,2401
2022-09,1115 - Department of Cannabis Control,205,34,38,16,65,1,359
2022-09,1700 - California Civil Rights Department,209,36,20,3,1,5,274
2022-09,1701 - Department of Financial Protection and Innovation,549,59,21,53,6,0,688
2022-09,1703 - California Privacy Protection Agency,17,0,0,0,0,1,18
2022-09,1750 - California Horse Racing Board,10,2,8,1,4,1,26
2022-09,2100 - Department of Alcoholic Beverage Control,62,27,55,93,102,146,485
2022-09,2120 - Alcoholic Beverage Control Appeals Board,2,1,2,1,0,0,6
2022-09,2240 - Department of Housing and Community Development,643,91,99,94,15,87,1029
2022-09,2320 - Department of Real Estate,21,114,135,26,15,3,314
2022-09,2600 - California Transportation Commission,23,2,8,2,1,0,36
2022-09,2660 - Department of Transportation,2901,2946,5974,1314,374,4,13513
2022-09,2665 - High-Speed Rail Authority,182,57,33,23,29,4,328
2022-09,2700 - California Traffic Safety Program,1,25,1,1,0,0,28
2022-09,2720 - California Highway Patrol,0,131,0,317,0,1013,1461
2022-09,3105 - California African-American Museum,0,0,0,0,18,0,18
2022-09,3125 - California Tahoe Conservancy,18,4,6,11,1,6,46
2022-09,3340 - California Conservation Corps,42,30,25,25,20,0,142
2022-09,3355 - Office of Energy Infrastructure Safety,55,0,0,0,0,1,56
2022-09,3360 - Energy Resources Conservation and Development Commission,582,48,23,11,5,1,670
2022-09,3480 - Department of Conservation,392,55,91,59,11,32,640
2022-09,3540 - Department of Forestry and Fire Protection,175,120,141,129,52,7,624
2022-09,3560 - State Lands Commission,93,27,16,15,5,4,160
2022-09,3600 - Department of Fish and Wildlife,642,443,246,260,79,276,1946
2022-09,3640 - Wildlife Conservation Board,21,2,2,0,0,5,30
2022-09,3720 - California Coastal Commission,48,62,40,9,6,2,167
2022-09,3760 - State Coastal Conservancy,43,15,2,2,0,0,62
2022-09,3780 - Native American Heritage Commission,7,0,0,1,0,0,8
2022-09,3790 - Department of Parks and Recreation,239,185,163,140,44,289,1060
2022-09,3810 - Santa Monica Mountains Conservancy,6,0,0,0,0,0,6
2022-09,3820 - San Francisco Bay Conservation and Development Commission,0,46,0,1,0,0,47
2022-09,3825 - San Gabriel and Lower Los Angeles Rivers and Mountains Conservancy,0,9,1,0,0,0,10
2022-09,3830 - San Joaquin River Conservancy,2,1,0,0,0,0,3
2022-09,3835 - Baldwin Hills Conservancy,1,1,1,0,0,0,3
2022-09,3840 - Delta Protection Commission,3,0,1,0,0,1,5
2022-09,3845 - San Diego River Conservancy,0,0,0,0,0,3,3
2022-09,3850 - Coachella Valley Mountains Conservancy,0,0,1,1,2,0,4
2022-09,3855 - Sierra Nevada Conservancy,18,12,8,7,0,1,46
2022-09,3860 - Department of Water Resources,187,399,982,668,115,29,2380
2022-09,3862 - Central Valley Flood Protection Board,21,15,7,1,6,0,50
2022-09,3875 - Sacramento-San Joaquin Delta Conservancy,10,2,0,1,0,0,13
2022-09,3885 - Delta Stewardship Council,46,10,6,1,1,0,64
2022-09,3900 - State Air Resources Board,198,614,466,199,113,32,1622
2022-09,3930 - Department of Pesticide Regulation,195,96,93,29,4,1,418
2022-09,3940 - State Water Resources Control Board,964,603,260,309,40,56,2232
2022-09,3960 - Department of Toxic Substances Control,672,139,93,105,31,78,1118
2022-09,3970 - Department of Resources Recycling and Recovery,435,100,47,25,13,1,621
2022-09,3980 - Office of Environmental Health Hazard Assessment,109,20,5,1,0,0,135
2022-09,4100 - State Council on Developmental Disabilities,30,4,12,5,6,3,60
2022-09,4140 - Department of Health Care Access and Information,193,50,19,110,22,66,460
2022-09,4150 - Department of Managed Health Care,604,5,12,0,0,0,621
2022-09,4170 - Department of Aging,190,15,12,8,1,1,227
2022-09,4250 - California Children and Families Commission,1,0,36,2,0,0,39
2022-09,4260 - State Department of Health Care Services,1937,963,304,134,44,612,3994
2022-09,4265 - Department of Public Health,2456,137,112,83,24,1126,3938
2022-09,4300 - Department of Developmental Services,386,95,50,32,10,23,596
2022-09,4440 - Department of State Hospitals,410,256,144,186,314,1,1311
2022-09,4560 - Mental Health Services Oversight and Accountability Commission,7,15,10,8,3,7,50
2022-09,4700 - Department of Community Services and Development,111,3,4,2,0,2,122
2022-09,4800 - California Health Benefit Exchange,1160,66,54,31,11,30,1352
2022-09,5160 - Department of Rehabilitation,233,228,506,383,134,130,1614
2022-09,5175 - Department of Child Support Services,452,91,10,12,14,0,579
2022-09,5180 - Department of Social Services,1563,445,472,1301,342,15,4138
2022-09,5225 - Department of Corrections and Rehabilitation,2616,710,835,912,531,1250,6854
2022-09,5227 - Board of State and Community Corrections,10,87,7,1,1,10,116
2022-09,5420 - Prison Industry Authority,11,46,90,51,2,27,227
2022-09,6120 - California State Library,56,21,16,27,22,4,146
2022-09,6125 - Education Audit Appeals Panel,0,2,1,0,0,0,3
2022-09,6250 - California School for the Deaf - Riverside,0,2,0,10,0,6,18
2022-09,6360 - Commission on Teacher Credentialing,27,71,28,13,7,16,162
2022-09,6870 - Board of Governors of the California Community Colleges,169,3,5,1,0,0,178
2022-09,"6980 - Student Aid Commission, California",90,21,10,1,1,5,128
2022-09,7100 - Employment Development Department,5225,680,756,422,237,45,7365
2022-09,7120 - California Workforce Development Board,71,0,0,0,0,0,71
2022-09,7300 - Agricultural Labor Relations Board,8,6,34,6,0,5,59
2022-09,7320 - Public Employment Relations Board,8,26,19,5,3,2,63
2022-09,7501 - Department of Human Resources,142,54,76,23,8,16,319
2022-09,7502 - California Department of Technology,774,47,32,8,6,65,932
2022-09,7503 - State Personnel Board,57,12,2,0,0,1,72
2022-09,7504 - Office of Data and Innovation,33,0,0,0,0,0,33
2022-09,7600 - California Department of Tax and Fee Administration,2482,621,360,102,17,17,3599
2022-09,7730 - Franchise Tax Board,187,282,3262,923,133,418,5205
2022-09,7760 - Department of General Services,801,186,194,269,57,381,1888
2022-09,7870 - California Victim Compensation Board,0,194,15,12,0,1,222
2022-09,7910 - Office of Administrative Law,2,7,6,6,2,0,23
2022-09,7920 - State Teachers' Retirement System,3,36,943,229,9,12,1232
2022-09,8120 - Commission on Peace Officer Standards and Training,2,0,0,126,0,5,133
2022-09,8140 - State Public Defender,39,4,12,13,1,9,78
2022-09,8560 - California Exposition and State Fair,0,0,0,0,0,0,0
2022-09,8570 - Department of Food and Agriculture,95,62,45,26,17,51,296
2022-09,8620 - Fair Political Practices Commission,61,16,11,2,0,1,91
2022-09,8660 - Public Utilities Commission,1135,68,46,24,7,19,1299
2022-09,"8780 - Milton Marks ""Little Hoover"" Commission on California State Government Organization and Economy",5,0,1,0,0,0,6
2022-09,8825 - Commission on Asian and Pacific Islander American Affairs,3,0,0,0,0,0,3
2022-09,"8830 - Law Revision Commission, California",8,0,0,0,0,0,8
2022-09,8860 - Department of Finance,39,28,274,30,6,9,386
2022-09,8880 - Financial Information System for California,268,11,5,2,2,0,288
2022-09,"8885 - States Mandates, Commission on",9,2,0,1,0,0,12
2022-09,8940 - Military Department,6,12,41,24,2,3,88
2022-09,8955 - Department of Veterans Affairs,126,92,127,65,19,28,457
2022-09,A059 - California Correctional Health Care Services,950,328,549,487,312,30,2656
2022-09,A314 - California Science Center,16,0,0,209,24,16,265
2022-09,A341 - California Earthquake Authority,64,4,2,2,0,1,73
2022-09,A424 - Cradle-to-Career,5,0,4,0,0,0,9
2022-09,A541 - Board of Forestry and Fire Protection,3,3,3,1,0,0,10
2022-10,0500 - Governor's Office,20,21,32,31,11,25,140
2022-10,0509 - Governor's Office of Business and Economic Development (GO-Biz),102,10,17,5,6,0,140
2022-10,0511 - Secretary for Government Operations Agency,6,10,7,1,0,0,24
2022-10,"0515 - Secretary for Business, Consumer Services, and Housing Agency",36,10,5,6,1,2,60
2022-10,0521 - Secretary for Transportation Agency,0,0,15,2,0,0,17
2022-10,0531 - Office of Systems Integration,326,15,7,1,2,5,356
2022-10,0540 - Secretary of the Natural Resources Agency,71,0,10,1,2,1,85
2022-10,0552 - Office of the Inspector General,107,7,5,3,4,11,137
2022-10,0555 - Secretary for Environmental Protection,41,6,2,2,2,23,76
2022-10,0559 - Secretary for Labor and Workforce Development Agency,3,3,8,8,2,4,28
2022-10,0650 - Office of Planning and Research,108,36,22,11,0,1,178
2022-10,0690 - Governor's Office of Emergency Services,247,183,137,225,116,508,1416
2022-10,0820 - Department of Justice,1718,585,683,544,317,388,4235
2022-10,0840 - State Controller,707,150,118,73,38,63,1149
2022-10,0845 - Department of Insurance,589,157,61,36,173,6,1022
2022-10,0855 - California Gambling Control Commission,25,8,7,0,0,0,40
2022-10,0860 - State Board of Equalization,24,2,113,15,1,1,156
2022-10,0890 - Secretary of State,90,38,356,33,21,23,561
2022-10,0911 - Citizens Redistricting Commission,5,1,2,0,0,0,8
2022-10,1045 - Cannabis Control Appeals Panel,5,1,0,1,0,1,8
2022-10,1111 - Department of Consumer Affairs,574,519,409,399,289,262,2452
2022-10,1115 - Department of Cannabis Control,212,39,37,16,69,0,373
2022-10,1700 - California Civil Rights Department,213,35,19,3,1,6,277
2022-10,1701 - Department of Financial Protection and Innovation,548,57,20,58,7,0,690
2022-10,1703 - California Privacy Protection Agency,19,0,0,0,0,1,20
2022-10,1750 - California Horse Racing Board,10,2,9,0,4,1,26
2022-10,2100 - Department of Alcoholic Beverage Control,61,27,59,98,108,133,486
2022-10,2120 - Alcoholic Beverage Control Appeals Board,2,1,2,1,0,0,6
2022-10,2240 - Department of Housing and Community Development,657,92,96,98,15,88,1046
2022-10,2320 - Department of Real Estate,21,118,124,26,15,3,307
2022-10,2600 - California Transportation Commission,23,2,8,2,1,0,36
2022-10,2660 - Department of Transportation,2914,2942,6036,1315,375,105,13687
2022-10,2665 - High-Speed Rail Authority,191,60,33,24,29,3,340
2022-10,2700 - California Traffic Safety Program,1,28,1,1,0,0,31
2022-10,2720 - California Highway Patrol,0,132,0,303,0,1014,1449
2022-10,2740 - Department of Motor Vehicles,398,98,307,185,39,795,1822
2022-10,3100 - Exposition Park,0,0,0,7,0,0,7
2022-10,3105 - California African-American Museum,0,0,0,0,16,0,16
2022-10,3125 - California Tahoe Conservancy,18,4,6,11,1,6,46
2022-10,3340 - California Conservation Corps,42,30,25,26,19,0,142
2022-10,3355 - Office of Energy Infrastructure Safety,61,0,0,0,0,1,62
2022-10,3360 - Energy Resources Conservation and Development Commission,592,48,23,11,5,1,680
2022-10,3480 - Department of Conservation,400,54,91,58,12,31,646
2022-10,3540 - Department of Forestry and Fire Protection,178,124,153,137,58,6,656
2022-10,3560 - State Lands Commission,92,27,16,16,5,3,159
2022-10,3600 - Department of Fish and Wildlife,139,922,298,278,97,228,1962
2022-10,3640 - Wildlife Conservation Board,21,2,2,0,0,6,31
2022-10,3720 - California Coastal Commission,48,63,40,10,6,2,169
2022-10,3760 - State Coastal Conservancy,43,15,2,2,0,0,62
2022-10,3780 - Native American Heritage Commission,7,0,0,1,0,0,8
2022-10,3790 - Department of Parks and Recreation,229,180,160,137,49,256,1011
2022-10,3810 - Santa Monica Mountains Conservancy,6,0,0,0,0,0,6
2022-10,3820 - San Francisco Bay Conservation and Development Commission,0,46,0,1,0,0,47
2022-10,3825 - San Gabriel and Lower Los Angeles Rivers and Mountains Conservancy,0,9,1,0,0,0,10
2022-10,3830 - San Joaquin River Conservancy,2,1,0,0,0,0,3
2022-10,3835 - Baldwin Hills Conservancy,1,1,1,0,0,0,3
2022-10,3840 - Delta Protection Commission,3,0,1,0,0,1,5
2022-10,3845 - San Diego River Conservancy,0,0,0,0,0,3,3
2022-10,3850 - Coachella Valley Mountains Conservancy,0,0,1,1,2,0,4
2022-10,3855 - Sierra Nevada Conservancy,19,11,9,7,0,0,46
2022-10,3860 - Department of Water Resources,191,407,1034,652,118,32,2434
2022-10,3862 - Central Valley Flood Protection Board,21,15,7,1,6,0,50
2022-10,3875 - Sacramento-San Joaquin Delta Conservancy,1,10,2,0,0,0,13
2022-10,3885 - Delta Stewardship Council,45,10,6,1,1,0,63
2022-10,3930 - Department of Pesticide Regulation,194,97,90,30,4,1,416
2022-10,3940 - State Water Resources Control Board,997,607,272,312,41,85,2314
2022-10,3960 - Department of Toxic Substances Control,674,138,93,117,33,77,1132
2022-10,3970 - Department of Resources Recycling and Recovery,430,105,49,24,13,1,622
2022-10,3980 - Office of Environmental Health Hazard Assessment,109,20,5,1,0,0,135
2022-10,4100 - State Council on Developmental Disabilities,30,5,16,5,7,3,66
2022-10,4140 - Department of Health Care Access and Information,195,52,20,109,22,70,468
2022-10,4150 - Department of Managed Health Care,606,5,12,0,0,0,623
2022-10,4170 - Department of Aging,182,31,17,10,0,1,241
2022-10,4250 - California Children and Families Commission,1,0,36,2,0,0,39
2022-10,4260 - State Department of Health Care Services,1956,1055,312,135,41,498,3997
2022-10,4265 - Department of Public Health,2456,137,112,83,24,1126,3938
2022-10,4300 - Department of Developmental Services,396,88,48,36,8,21,597
2022-10,4440 - Department of State Hospitals,354,218,80,142,231,5,1030
2022-10,4560 - Mental Health Services Oversight and Accountability Commission,7,15,10,8,3,7,50
2022-10,4700 - Department of Community Services and Development,111,3,4,2,0,2,122
2022-10,4800 - California Health Benefit Exchange,1170,65,54,32,9,29,1359
2022-10,5160 - Department of Rehabilitation,225,225,486,374,131,143,1584
2022-10,5170 - State Independent Living Council,2,0,0,0,0,0,2
2022-10,5175 - Department of Child Support Services,451,91,10,12,13,0,577
2022-10,5180 - Department of Social Services,1671,502,477,1372,389,0,4411
2022-10,5225 - Department of Corrections and Rehabilitation,2030,439,725,813,466,1249,5722
2022-10,5227 - Board of State and Community Corrections,9,87,7,1,1,10,115
2022-10,5420 - Prison Industry Authority,7,32,69,38,2,46,194
2022-10,6120 - California State Library,57,24,16,27,21,3,148
2022-10,6125 - Education Audit Appeals Panel,0,2,1,0,0,0,3
2022-10,6240 - California School for the Deaf - Fremont,4,0,0,0,0,0,4
2022-10,6250 - California School for the Deaf - Riverside,0,2,2,5,3,6,18
2022-10,6360 - Commission on Teacher Credentialing,23,82,30,13,6,19,173
2022-10,6870 - Board of Governors of the California Community Colleges,168,3,5,1,0,0,177
2022-10,"6980 - Student Aid Commission, California",90,21,10,1,1,5,128
2022-10,7100 - Employment Development Department,5257,684,769,427,239,49,7425
2022-10,7120 - California Workforce Development Board,71,0,0,0,0,0,71
2022-10,7300 - Agricultural Labor Relations Board,8,6,36,6,0,9,65
2022-10,7320 - Public Employment Relations Board,8,26,19,5,3,2,63
2022-10,7501 - Department of Human Resources,137,49,58,10,3,8,265
2022-10,7502 - California Department of Technology,769,46,32,8,6,68,929
2022-10,7503 - State Personnel Board,55,13,3,0,0,1,72
2022-10,7504 - Office of Data and Innovation,33,0,0,0,0,0,33
2022-10,7600 - California Department of Tax and Fee Administration,2473,625,364,103,18,17,3600
2022-10,7730 - Franchise Tax Board,185,265,3306,943,137,409,5245
2022-10,7760 - Department of General Services,819,191,201,280,56,374,1921
2022-10,7870 - California Victim Compensation Board,0,196,15,12,0,1,224
2022-10,7910 - Office of Administrative Law,2,7,6,6,2,0,23
2022-10,7920 - State Teachers' Retirement System,3,36,943,227,9,0,1218
2022-10,8120 - Commission on Peace Officer Standards and Training,2,0,0,130,1,4,137
2022-10,8140 - State Public Defender,43,4,12,13,1,11,84
2022-10,8560 - California Exposition and State Fair,0,0,0,0,0,0,0
2022-10,8570 - Department of Food and Agriculture,162,115,90,52,39,97,555
2022-10,8620 - Fair Political Practices Commission,62,16,10,2,0,1,91
2022-10,8660 - Public Utilities Commission,1136,68,43,26,7,23,1303
2022-10,"8780 - Milton Marks ""Little Hoover"" Commission on California State Government Organization and Economy",5,0,1,0,0,0,6
2022-10,8825 - Commission on Asian and Pacific Islander American Affairs,3,0,0,0,0,0,3
2022-10,"8830 - Law Revision Commission, California",8,0,0,0,0,0,8
2022-10,8860 - Department of Finance,39,29,277,29,6,9,389
2022-10,8880 - Financial Information System for California,267,10,3,5,1,1,287
2022-10,"8885 - States Mandates, Commission on",7,2,0,3,0,0,12
2022-10,8940 - Military Department,4,12,44,28,4,4,96
2022-10,8955 - Department of Veterans Affairs,126,92,127,64,19,31,459
2022-10,A059 - California Correctional Health Care Services,944,327,551,485,335,31,2673
2022-10,A279 - Unemployment Insurance Appeals Board,77,79,29,29,17,147,378
2022-10,A281 - Employment Training Panel,27,13,15,7,8,0,70
2022-10,A314 - California Science Center,2,0,0,25,3,2,32
2022-10,A341 - California Earthquake Authority,59,4,2,2,0,1,68
2022-10,A424 - Cradle-to-Career,5,0,5,0,0,0,10
2022-10,A541 - Board of Forestry and Fire Protection,3,3,3,1,0,0,10
2022-11,0500 - Governor's Office,19,22,32,31,10,26,140
2022-11,0509 - Governor's Office of Business and Economic Development (GO-Biz),104,12,18,5,6,0,145
2022-11,0511 - Secretary for Government Operations Agency,6,10,7,1,0,0,24
2022-11,"0515 - Secretary for Business, Consumer Services, and Housing Agency",35,10,5,6,2,2,60
2022-11,0521 - Secretary for Transportation Agency,0,0,15,2,0,0,17
2022-11,0531 - Office of Systems Integration,338,15,8,1,2,6,370
2022-11,0540 - Secretary of the Natural Resources Agency,78,0,10,1,2,2,93
2022-11,0552 - Office of the Inspector General,109,7,8,1,5,10,140
2022-11,0555 - Secretary for Environmental Protection,41,6,2,2,2,23,76
2022-11,0559 - Secretary for Labor and Workforce Development Agency,3,3,8,8,2,4,28
2022-11,0690 - Governor's Office of Emergency Services,16,185,240,201,233,534,1409
2022-11,0820 - Department of Justice,1711,599,673,561,286,363,4193
2022-11,0840 - State Controller,716,151,121,70,38,61,1157
2022-11,0845 - Department of Insurance,593,165,67,38,177,6,1046
2022-11,0855 - California Gambling Control Commission,25,8,7,0,0,0,40
2022-11,0860 - State Board of Equalization,24,2,113,15,2,1,157
2022-11,0890 - Secretary of State,89,38,364,35,18,17,561
2022-11,0911 - Citizens Redistricting Commission,5,1,2,0,0,0,8
2022-11,1045 - Cannabis Control Appeals Panel,5,1,0,1,0,1,8
2022-11,1111 - Department of Consumer Affairs,594,555,462,441,303,262,2617
2022-11,1115 - Department of Cannabis Control,214,39,40,16,70,0,379
2022-11,1700 - California Civil Rights Department,202,36,19,3,1,5,266
2022-11,1701 - Department of Financial Protection and Innovation,550,58,20,58,7,0,693
2022-11,1703 - California Privacy Protection Agency,19,0,1,0,0,0,20
2022-11,1750 - California Horse Racing Board,10,2,9,0,4,1,26
2022-11,2100 - Department of Alcoholic Beverage Control,48,26,57,96,110,140,477
2022-11,2120 - Alcoholic Beverage Control Appeals Board,2,1,2,1,0,0,6
2022-11,2240 - Department of Housing and Community Development,664,90,92,96,15,85,1042
2022-11,2320 - Department of Real Estate,21,118,124,26,15,3,307
2022-11,2600 - California Transportation Commission,23,2,10,2,1,0,38
2022-11,2660 - Department of Transportation,2913,2941,6033,1314,374,105,13680
2022-11,2665 - High-Speed Rail Authority,191,61,34,23,28,5,342
2022-11,2700 - California Traffic Safety Program,2,26,2,1,0,0,31
2022-11,2720 - California Highway Patrol,0,133,0,299,0,1015,1447
2022-11,2740 - Department of Motor Vehicles,436,105,337,215,50,580,1723
2022-11,3100 - Exposition Park,0,0,0,7,0,0,7
2022-11,3105 - California African-American Museum,0,0,0,0,16,0,16
2022-11,3125 - California Tahoe Conservancy,18,4,6,11,1,6,46
2022-11,3340 - California Conservation Corps,42,31,24,27,19,0,143
2022-11,3355 - Office of Energy Infrastructure Safety,61,0,0,0,0,1,62
2022-11,3360 - Energy Resources Conservation and Development Commission,597,48,23,13,5,1,687
2022-11,3480 - Department of Conservation,399,53,89,57,12,32,642
2022-11,3540 - Department of Forestry and Fire Protection,171,121,148,135,57,6,638
2022-11,3560 - State Lands Commission,93,27,15,16,5,4,160
2022-11,3600 - Department of Fish and Wildlife,120,924,298,268,95,260,1965
2022-11,3640 - Wildlife Conservation Board,19,2,2,0,0,9,32
2022-11,3720 - California Coastal Commission,48,67,41,10,6,2,174
2022-11,3760 - State Coastal Conservancy,43,16,2,2,0,0,63
2022-11,3780 - Native American Heritage Commission,7,0,0,1,0,0,8
2022-11,3790 - Department of Parks and Recreation,221,164,145,124,34,362,1050
2022-11,3810 - Santa Monica Mountains Conservancy,6,0,0,0,0,0,6
2022-11,3820 - San Francisco Bay Conservation and Development Commission,0,46,0,1,0,0,47
2022-11,3825 - San Gabriel and Lower Los Angeles Rivers and Mountains Conservancy,0,8,1,0,0,1,10
2022-11,3830 - San Joaquin River Conservancy,2,1,0,0,0,0,3
2022-11,3835 - Baldwin Hills Conservancy,1,1,1,0,0,0,3
2022-11,3840 - Delta Protection Commission,3,0,2,0,0,1,6
2022-11,3845 - San Diego River Conservancy,0,0,0,0,0,3,3
2022-11,3850 - Coachella Valley Mountains Conservancy,0,0,1,1,2,0,4
2022-11,3855 - Sierra Nevada Conservancy,22,9,8,7,0,0,46
2022-11,3860 - Department of Water Resources,189,407,994,678,120,31,2419
2022-11,3862 - Central Valley Flood Protection Board,20,15,7,1,6,0,49
2022-11,3875 - Sacramento-San Joaquin Delta Conservancy,3,9,2,0,0,0,14
2022-11,3885 - Delta Stewardship Council,46,10,6,1,1,0,64
2022-11,3930 - Department of Pesticide Regulation,194,100,88,30,4,0,416
2022-11,3940 - State Water Resources Control Board,1024,611,274,311,46,82,2348
2022-11,3960 - Department of Toxic Substances Control,18,4,2,14,2,2,42
2022-11,3970 - Department of Resources Recycling and Recovery,432,105,49,25,13,1,625
2022-11,3980 - Office of Environmental Health Hazard Assessment,109,20,5,1,0,0,135
2022-11,4100 - State Council on Developmental Disabilities,30,5,16,5,7,3,66
2022-11,4140 - Department of Health Care Access and Information,197,55,21,111,24,65,473
2022-11,4150 - Department of Managed Health Care,609,5,10,0,0,0,624
2022-11,4170 - Department of Aging,189,29,17,9,0,1,245
2022-11,4250 - California Children and Families Commission,1,0,35,1,0,0,37
2022-11,4260 - State Department of Health Care Services,1992,1067,302,137,37,493,4028
2022-11,4265 - Department of Public Health,2456,137,112,83,24,1126,3938
2022-11,4300 - Department of Developmental Services,394,97,46,36,10,19,602
2022-11,4440 - Department of State Hospitals,382,240,120,180,334,2,1258
2022-11,4560 - Mental Health Services Oversight and Accountability Commission,7,15,10,8,3,7,50
2022-11,4700 - Department of Community Services and Development,111,3,4,2,0,2,122
2022-11,4800 - California Health Benefit Exchange,1146,61,54,31,9,30,1331
2022-11,5160 - Department of Rehabilitation,239,231,490,391,134,164,1649
2022-11,5170 - State Independent Living Council,2,0,0,0,0,0,2
2022-11,5175 - Department of Child Support Services,458,87,10,12,13,1,581
2022-11,5180 - Department of Social Services,1714,587,374,1403,406,6,4490
2022-11,5225 - Department of Corrections and Rehabilitation,2076,442,746,855,504,1247,5870
2022-11,5227 - Board of State and Community Corrections,9,87,6,1,2,11,116
2022-11,5420 - Prison Industry Authority,12,46,90,48,2,3,201
2022-11,6120 - California State Library,57,24,16,27,21,3,148
2022-11,6125 - Education Audit Appeals Panel,0,2,1,0,0,0,3
2022-11,6240 - California School for the Deaf - Fremont,4,0,0,0,0,0,4
2022-11,6250 - California School for the Deaf - Riverside,0,2,2,5,3,6,18
2022-11,6360 - Commission on Teacher Credentialing,24,83,30,15,5,25,182
2022-11,6870 - Board of Governors of the California Community Colleges,168,2,5,1,0,0,176
2022-11,"6980 - Student Aid Commission, California",90,21,10,1,1,5,128
2022-11,7100 - Employment Development Department,5254,694,780,424,239,51,7442
2022-11,7120 - California Workforce Development Board,69,0,0,0,0,0,69
2022-11,7300 - Agricultural Labor Relations Board,8,6,36,6,0,9,65
2022-11,7320 - Public Employment Relations Board,8,26,19,5,3,2,63
2022-11,7501 - Department of Human Resources,138,48,63,10,3,6,268
2022-11,7502 - California Department of Technology,775,46,31,7,6,68,933
2022-11,7503 - State Personnel Board,59,8,2,0,0,1,70
2022-11,7504 - Office of Data and Innovation,35,0,0,0,0,0,35
2022-11,7600 - California Department of Tax and Fee Administration,2468,627,364,103,18,17,3597
2022-11,7730 - Franchise Tax Board,190,250,3288,949,142,401,5220
2022-11,7760 - Department of General Services,815,201,202,297,57,375,1947
2022-11,7870 - California Victim Compensation Board,0,198,15,12,0,1,226
2022-11,7910 - Office of Administrative Law,2,7,6,6,2,0,23
2022-11,7920 - State Teachers' Retirement System,3,34,966,224,9,0,1236
2022-11,8120 - Commission on Peace Officer Standards and Training,2,0,0,139,1,4,146
2022-11,8140 - State Public Defender,46,4,12,12,1,11,86
2022-11,8560 - California Exposition and State Fair,0,0,0,0,0,0,0
2022-11,8570 - Department of Food and Agriculture,162,124,97,54,30,100,567
2022-11,8620 - Fair Political Practices Commission,62,16,10,2,0,1,91
2022-11,8660 - Public Utilities Commission,1133,73,45,25,7,25,1308
2022-11,"8780 - Milton Marks ""Little Hoover"" Commission on California State Government Organization and Economy",5,0,1,0,0,0,6
2022-11,8825 - Commission on Asian and Pacific Islander American Affairs,3,0,0,0,0,0,3
2022-11,"8830 - Law Revision Commission, California",8,0,0,0,0,0,8
2022-11,8860 - Department of Finance,39,29,281,28,5,7,389
2022-11,8880 - Financial Information System for California,273,9,7,3,1,0,293
2022-11,"8885 - States Mandates, Commission on",6,3,0,3,0,0,12
2022-11,8955 - Department of Veterans Affairs,126,91,127,65,19,34,462
2022-11,A059 - California Correctional Health Care Services,967,333,547,479,309,2,2637
2022-11,A279 - Unemployment Insurance Appeals Board,76,76,33,29,18,156,388
2022-11,A281 - Employment Training Panel,27,13,15,7,8,0,70
2022-11,A314 - California Science Center,2,0,0,25,3,2,32
2022-11,A341 - California Earthquake Authority,59,4,2,2,0,1,68
2022-11,A424 - Cradle-to-Career,4,0,6,0,0,0,10
2022-11,A541 - Board of Forestry and Fire Protection,3,3,3,1,0,0,10
2022-12,0500 - Governor's Office,18,17,38,33,11,26,143
2022-12,0509 - Governor's Office of Business and Economic Development (GO-Biz),102,12,19,5,6,0,144
2022-12,0511 - Secretary for Government Operations Agency,6,12,9,1,0,0,28
2022-12,"0515 - Secretary for Business, Consumer Services, and Housing Agency",38,9,5,6,2,1,61
2022-12,0521 - Secretary for Transportation Agency,0,0,15,2,0,0,17
2022-12,0530 - Secretary for California Health and Human Services Agency,46,9,6,9,2,0,72
2022-12,0531 - Office of Systems Integration,338,15,9,1,2,6,371
2022-12,0540 - Secretary of the Natural Resources Agency,77,0,10,1,2,1,91
2022-12,0552 - Office of the Inspector General,109,7,6,4,4,9,139
2022-12,0555 - Secretary for Environmental Protection,40,6,3,2,2,23,76
2022-12,0559 - Secretary for Labor and Workforce Development Agency,3,3,8,8,2,4,28
2022-12,0690 - Governor's Office of Emergency Services,13,251,218,213,200,379,1274
2022-12,0820 - Department of Justice,1719,602,674,566,310,358,4229
2022-12,0840 - State Controller,724,152,122,70,39,60,1167
2022-12,0845 - Department of Insurance,575,175,61,35,173,7,1026
2022-12,0855 - California Gambling Control Commission,25,7,8,0,0,0,40
2022-12,0860 - State Board of Equalization,24,2,112,15,1,1,155
2022-12,0890 - Secretary of State,91,40,361,36,18,17,563
2022-12,0911 - Citizens Redistricting Commission,4,1,2,0,0,0,7
2022-12,1045 - Cannabis Control Appeals Panel,5,1,0,1,0,1,8
2022-12,1111 - Department of Consumer Affairs,582,516,453,436,302,261,2550
2022-12,1115 - Department of Cannabis Control,218,39,41,22,68,0,388
2022-12,1700 - California Civil Rights Department,202,36,19,3,1,5,266
2022-12,1701 - Department of Financial Protection and Innovation,555,59,19,61,6,0,700
2022-12,1703 - California Privacy Protection Agency,19,0,1,0,0,0,20
2022-12,1750 - California Horse Racing Board,10,2,9,0,4,1,26
2022-12,2100 - Department of Alcoholic Beverage Control,47,26,57,94,112,135,471
2022-12,2120 - Alcoholic Beverage Control Appeals Board,2,1,2,1,0,0,6
2022-12,2240 - Department of Housing and Community Development,672,91,95,95,16,84,1053
2022-12,2320 - Department of Real Estate,21,119,127,27,16,3,313
2022-12,2600 - California Transportation Commission,22,2,10,2,1,0,37
2022-12,2660 - Department of Transportation,2913,2941,6033,1314,374,105,13680
2022-12,2665 - High-Speed Rail Authority,188,60,38,26,28,7,347
2022-12,2700 - California Traffic Safety Program,2,26,2,1,0,0,31
2022-12,2720 - California Highway Patrol,0,135,0,262,0,1047,1444
2022-12,2740 - Department of Motor Vehicles,463,109,351,225,58,522,1728
2022-12,3100 - Exposition Park,0,0,0,7,0,0,7
2022-12,3105 - California African-American Museum,0,0,0,0,16,0,16
2022-12,3125 - California Tahoe Conservancy,18,4,6,11,1,6,46
2022-12,3340 - California Conservation Corps,41,31,28,25,16,0,141
2022-12,3355 - Office of Energy Infrastructure Safety,65,0,0,0,0,0,65
2022-12,3360 - Energy Resources Conservation and Development Commission,596,48,22,12,5,1,684
2022-12,3480 - Department of Conservation,401,54,91,58,11,32,647
2022-12,3540 - Department of Forestry and Fire Protection,165,114,115,116,38,5,553
2022-12,3560 - State Lands Commission,91,27,15,17,6,6,162
2022-12,3600 - Department of Fish and Wildlife,111,914,292,266,99,282,1964
2022-12,3640 - Wildlife Conservation Board,20,2,2,0,0,9,33
2022-12,3720 - California Coastal Commission,48,68,41,10,6,2,175
2022-12,3760 - State Coastal Conservancy,43,18,2,2,0,0,65
2022-12,3780 - Native American Heritage Commission,7,0,0,1,0,0,8
2022-12,3790 - Department of Parks and Recreation,213,179,156,130,32,552,1262
2022-12,3810 - Santa Monica Mountains Conservancy,6,0,0,0,0,0,6
2022-12,3820 - San Francisco Bay Conservation and Development Commission,0,45,1,1,0,0,47
2022-12,3825 - San Gabriel and Lower Los Angeles Rivers and Mountains Conservancy,0,7,1,1,0,1,10
2022-12,3830 - San Joaquin River Conservancy,2,1,0,0,0,0,3
2022-12,3835 - Baldwin Hills Conservancy,1,1,1,0,0,0,3
2022-12,3840 - Delta Protection Commission,3,0,2,0,1,1,7
2022-12,3845 - San Diego River Conservancy,0,0,0,0,0,3,3
2022-12,3850 - Coachella Valley Mountains Conservancy,0,0,1,1,2,0,4
2022-12,3855 - Sierra Nevada Conservancy,21,8,11,7,0,0,47
2022-12,3860 - Department of Water Resources,188,407,984,646,129,5,2359
2022-12,3862 - Central Valley Flood Protection Board,13,13,2,1,5,0,34
2022-12,3875 - Sacramento-San Joaquin Delta Conservancy,11,4,0,0,0,0,15
2022-12,3885 - Delta Stewardship Council,45,10,6,1,1,0,63
2022-12,3930 - Department of Pesticide Regulation,194,95,84,32,7,1,413
2022-12,3940 - State Water Resources Control Board,1023,598,270,312,47,149,2399
2022-12,3960 - Department of Toxic Substances Control,701,145,98,127,34,81,1186
2022-12,3970 - Department of Resources Recycling and Recovery,393,89,41,18,8,0,549
2022-12,3980 - Office of Environmental Health Hazard Assessment,109,20,5,1,0,0,135
2022-12,4100 - State Council on Developmental Disabilities,30,5,16,5,7,3,66
2022-12,4140 - Department of Health Care Access and Information,209,55,23,113,24,65,489
2022-12,4150 - Department of Managed Health Care,609,5,10,0,0,0,624
2022-12,4170 - Department of Aging,192,23,16,8,0,1,240
2022-12,4250 - California Children and Families Commission,1,0,37,1,0,0,39
2022-12,4260 - State Department of Health Care Services,2025,1094,305,136,35,426,4021
2022-12,4265 - Department of Public Health,2456,137,112,83,24,1126,3938
2022-12,4300 - Department of Developmental Services,395,99,41,39,10,18,602
2022-12,4440 - Department of State Hospitals,376,222,137,158,358,2,1253
2022-12,4560 - Mental Health Services Oversight and Accountability Commission,7,15,10,8,3,7,50
2022-12,4700 - Department of Community Services and Development,111,3,4,3,0,1,122
2022-12,4800 - California Health Benefit Exchange,1149,60,52,32,8,21,1322
2022-12,5160 - Department of Rehabilitation,234,228,480,392,130,158,1622
2022-12,5170 - State Independent Living Council,2,0,0,0,0,0,2
2022-12,5175 - Department of Child Support Services,459,90,10,12,13,0,584
2022-12,5180 - Department of Social Services,1704,545,404,1392,396,4,4445
2022-12,5225 - Department of Corrections and Rehabilitation,2106,448,759,881,523,1247,5964
2022-12,5227 - Board of State and Community Corrections,8,87,6,0,2,11,114
2022-12,5420 - Prison Industry Authority,11,43,91,49,2,38,234
2022-12,6100 - Department of Education,901,94,87,19,16,164,1281
2022-12,6120 - California State Library,57,23,16,27,22,3,148
2022-12,6125 - Education Audit Appeals Panel,0,2,1,0,0,0,3
2022-12,6240 - California School for the Deaf - Fremont,4,0,0,0,0,0,4
2022-12,6250 - California School for the Deaf - Riverside,0,2,2,5,3,6,18
2022-12,6360 - Commission on Teacher Credentialing,25,83,29,15,8,19,179
2022-12,6870 - Board of Governors of the California Community Colleges,167,2,6,1,0,0,176
2022-12,"6980 - Student Aid Commission, California",90,21,10,1,1,5,128
2022-12,7100 - Employment Development Department,5240,698,788,429,249,52,7456
2022-12,7120 - California Workforce Development Board,76,0,0,0,0,0,76
2022-12,7300 - Agricultural Labor Relations Board,8,6,36,6,0,9,65
2022-12,7320 - Public Employment Relations Board,8,26,19,5,3,2,63
2022-12,7501 - Department of Human Resources,144,50,64,10,3,7,278
2022-12,7502 - California Department of Technology,794,47,32,7,6,84,970
2022-12,7503 - State Personnel Board,53,13,2,1,1,1,71
2022-12,7504 - Office of Data and Innovation,35,0,2,0,0,0,37
2022-12,7600 - California Department of Tax and Fee Administration,2454,630,364,101,16,15,3580
2022-12,7730 - Franchise Tax Board,190,242,3284,927,139,391,5173
2022-12,7760 - Department of General Services,834,208,209,292,56,363,1962
2022-12,7870 - California Victim Compensation Board,0,197,15,12,0,1,225
2022-12,7900 - Public Employees' Retirement System,268,9,14,1826,112,84,2313
2022-12,7910 - Office of Administrative Law,2,7,6,6,2,0,23
2022-12,7920 - State Teachers' Retirement System,3,34,983,223,9,0,1252
2022-12,8120 - Commission on Peace Officer Standards and Training,2,0,0,142,1,4,149
2022-12,8140 - State Public Defender,46,4,12,11,0,11,84
2022-12,8560 - California Exposition and State Fair,0,0,0,0,0,0,0
2022-12,8570 - Department of Food and Agriculture,169,139,102,69,37,104,620
2022-12,8620 - Fair Political Practices Commission,62,16,10,2,0,1,91
2022-12,8660 - Public Utilities Commission,1160,75,44,24,6,25,1334
2022-12,"8780 - Milton Marks ""Little Hoover"" Commission on California State Government Organization and Economy",5,0,1,0,0,0,6
2022-12,8825 - Commission on Asian and Pacific Islander American Affairs,3,0,0,0,0,0,3
2022-12,"8830 - Law Revision Commission, California",8,0,0,0,0,0,8
2022-12,8860 - Department of Finance,40,29,279,28,6,7,389
2022-12,8880 - Financial Information System for California,276,12,6,4,2,1,301
2022-12,"8885 - States Mandates, Commission on",5,4,0,3,0,0,12
2022-12,8940 - Military Department,4,12,44,27,4,5,96
2022-12,8955 - Department of Veterans Affairs,125,92,128,65,18,38,466
2022-12,A059 - California Correctional Health Care Services,958,329,537,473,354,22,2673
2022-12,A279 - Unemployment Insurance Appeals Board,76,73,33,28,18,160,388
2022-12,A281 - Employment Training Panel,27,13,15,7,8,0,70
2022-12,A314 - California Science Center,2,0,0,25,3,2,32
2022-12,A341 - California Earthquake Authority,59,4,2,2,0,1,68
2022-12,A424 - Cradle-to-Career,4,0,6,0,0,0,10
2022-12,A541 - Board of Forestry and Fire Protection,2,3,2,0,0,0,7
2023-01,0500 - Governor's Office,13,13,41,31,10,25,133
2023-01,0509 - Governor's Office of Business and Economic Development (GO-Biz),103,12,19,5,6,0,145
2023-01,0511 - Secretary for Government Operations Agency,0,12,9,2,0,0,23
2023-01,"0515 - Secretary for Business, Consumer Services, and Housing Agency",39,8,5,6,2,1,61
2023-01,0521 - Secretary for Transportation Agency,0,0,15,2,0,0,17
2023-01,0530 - Secretary for California Health and Human Services Agency,46,9,6,10,2,0,73
2023-01,0531 - Office of Systems Integration,337,15,10,1,2,6,371
2023-01,0540 - Secretary of the Natural Resources Agency,74,0,10,2,2,1,89
2023-01,0552 - Office of the Inspector General,111,7,7,2,5,9,141
2023-01,0555 - Secretary for Environmental Protection,41,6,3,2,2,38,92
2023-01,0559 - Secretary for Labor and Workforce Development Agency,4,3,7,11,2,5,32
2023-01,0650 - Office of Planning and Research,123,38,22,11,0,2,196
2023-01,0690 - Governor's Office of Emergency Services,23,259,197,212,188,358,1237
2023-01,0820 - Department of Justice,1711,616,680,586,288,357,4238
2023-01,0840 - State Controller,724,152,122,70,39,60,1167
2023-01,0845 - Department of Insurance,526,215,61,35,170,6,1013
2023-01,0855 - California Gambling Control Commission,27,8,8,0,0,0,43
2023-01,0860 - State Board of Equalization,20,4,114,15,1,0,154
2023-01,0911 - Citizens Redistricting Commission,3,1,2,0,0,0,6
2023-01,1045 - Cannabis Control Appeals Panel,5,1,0,1,0,1,8
2023-01,1111 - Department of Consumer Affairs,586,516,455,442,315,223,2537
2023-01,1115 - Department of Cannabis Control,218,44,46,20,64,1,393
2023-01,1700 - California Civil Rights Department,205,35,19,3,1,4,267
2023-01,1701 - Department of Financial Protection and Innovation,551,61,16,62,6,1,697
2023-01,1703 - California Privacy Protection Agency,19,0,1,0,0,0,20
2023-01,1750 - California Horse Racing Board,11,2,7,0,5,1,26
2023-01,2100 - Department of Alcoholic Beverage Control,49,29,59,90,135,114,476
2023-01,2120 - Alcoholic Beverage Control Appeals Board,2,1,2,1,0,0,6
2023-01,2240 - Department of Housing and Community Development,692,93,97,95,17,97,1091
2023-01,2320 - Department of Real Estate,21,119,127,27,16,3,313
2023-01,2600 - California Transportation Commission,22,2,10,2,1,0,37
2023-01,2660 - Department of Transportation,2913,2941,6033,1314,374,105,13680
2023-01,2665 - High-Speed Rail Authority,182,66,39,26,28,7,348
2023-01,2700 - California Traffic Safety Program,2,26,2,1,0,0,31
2023-01,2720 - California Highway Patrol,0,125,0,168,0,1142,1435
2023-01,2740 - Department of Motor Vehicles,471,109,369,226,61,475,1711
2023-01,3100 - Exposition Park,0,0,0,8,0,1,9
2023-01,3105 - California African-American Museum,0,0,0,0,16,0,16
2023-01,3125 - California Tahoe Conservancy,18,4,6,11,1,6,46
2023-01,3340 - California Conservation Corps,41,32,29,25,16,0,143
2023-01,3355 - Office of Energy Infrastructure Safety,64,0,0,0,0,1,65
2023-01,3360 - Energy Resources Conservation and Development Commission,608,46,23,11,5,1,694
2023-01,3480 - Department of Conservation,396,58,92,52,11,33,642
2023-01,3540 - Department of Forestry and Fire Protection,185,134,145,136,49,5,654
2023-01,3560 - State Lands Commission,90,26,15,15,6,29,181
2023-01,3600 - Department of Fish and Wildlife,84,933,302,271,101,277,1968
2023-01,3640 - Wildlife Conservation Board,18,3,3,2,0,9,35
2023-01,3720 - California Coastal Commission,48,68,42,10,6,2,176
2023-01,3760 - State Coastal Conservancy,43,18,2,2,0,0,65
2023-01,3780 - Native American Heritage Commission,0,1,4,2,1,0,8
2023-01,3790 - Department of Parks and Recreation,197,180,169,132,39,733,1450
2023-01,3810 - Santa Monica Mountains Conservancy,6,0,0,0,0,0,6
2023-01,3820 - San Francisco Bay Conservation and Development Commission,0,44,1,1,0,0,46
2023-01,3825 - San Gabriel and Lower Los Angeles Rivers and Mountains Conservancy,1,7,1,0,0,0,9
2023-01,3830 - San Joaquin River Conservancy,2,2,0,0,0,0,4
2023-01,3835 - Baldwin Hills Conservancy,0,1,2,1,0,0,4
2023-01,3840 - Delta Protection Commission,3,0,2,0,1,1,7
2023-01,3845 - San Diego River Conservancy,0,0,0,0,0,3,3
2023-01,3850 - Coachella Valley Mountains Conservancy,0,0,1,1,2,0,4
2023-01,3855 - Sierra Nevada Conservancy,19,9,13,8,0,0,49
2023-01,3860 - Department of Water Resources,188,406,982,630,127,5,2338
2023-01,3862 - Central Valley Flood Protection Board,20,19,9,1,6,0,55
2023-01,3875 - Sacramento-San Joaquin Delta Conservancy,13,3,0,0,0,0,16
2023-01,3885 - Delta Stewardship Council,44,10,6,1,1,0,62
2023-01,3900 - State Air Resources Board,40,855,151,144,271,103,1564
2023-01,3930 - Department of Pesticide Regulation,195,96,80,31,9,0,411
2023-01,3940 - State Water Resources Control Board,1045,618,260,330,44,101,2398
2023-01,3960 - Department of Toxic Substances Control,707,151,99,136,34,81,1208
2023-01,3970 - Department of Resources Recycling and Recovery,380,95,38,27,10,0,550
2023-01,3980 - Office of Environmental Health Hazard Assessment,109,20,5,1,0,0,135
2023-01,4100 - State Council on Developmental Disabilities,30,5,16,5,7,3,66
2023-01,4140 - Department of Health Care Access and Information,226,47,30,112,10,69,494
2023-01,4150 - Department of Managed Health Care,603,5,10,0,0,0,618
2023-01,4170 - Department of Aging,197,22,16,8,0,1,244
2023-01,4250 - California Children and Families Commission,1,0,37,1,0,0,39
2023-01,4260 - State Department of Health Care Services,2023,1097,296,129,34,460,4039
2023-01,4265 - Department of Public Health,2456,137,112,83,24,1126,3938
2023-01,4300 - Department of Developmental Services,397,100,43,37,10,19,606
2023-01,4440 - Department of State Hospitals,378,234,119,162,365,43,1301
2023-01,4560 - Mental Health Services Oversight and Accountability Commission,7,15,10,8,3,7,50
2023-01,4700 - Department of Community Services and Development,109,3,4,2,0,1,119
2023-01,4800 - California Health Benefit Exchange,1153,59,57,30,7,19,1325
2023-01,5160 - Department of Rehabilitation,235,229,484,398,130,158,1634
2023-01,5170 - State Independent Living Council,2,0,0,0,0,0,2
2023-01,5175 - Department of Child Support Services,456,95,10,12,13,0,586
2023-01,5180 - Department of Social Services,1638,620,409,1397,428,9,4501
2023-01,5225 - Department of Corrections and Rehabilitation,1981,410,711,849,497,1051,5499
2023-01,5227 - Board of State and Community Corrections,8,87,6,1,2,11,115
2023-01,5420 - Prison Industry Authority,11,41,93,46,4,19,214
2023-01,6100 - Department of Education,905,93,86,20,16,173,1293
2023-01,6120 - California State Library,59,23,16,28,22,3,151
2023-01,6125 - Education Audit Appeals Panel,0,2,1,0,0,0,3
2023-01,6240 - California School for the Deaf - Fremont,4,0,0,0,0,0,4
2023-01,6250 - California School for the Deaf - Riverside,0,2,2,5,3,5,17
2023-01,6360 - Commission on Teacher Credentialing,25,84,27,19,8,20,183
2023-01,6870 - Board of Governors of the California Community Colleges,173,2,6,1,0,0,182
2023-01,"6980 - Student Aid Commission, California",90,21,10,1,1,5,128
2023-01,7100 - Employment Development Department,5204,703,789,427,253,53,7429
2023-01,7120 - California Workforce Development Board,71,0,0,0,0,0,71
2023-01,7300 - Agricultural Labor Relations Board,8,6,36,5,0,10,65
2023-01,7320 - Public Employment Relations Board,8,26,19,5,3,2,63
2023-01,7501 - Department of Human Resources,147,48,60,10,3,7,275
2023-01,7502 - California Department of Technology,782,47,32,7,6,84,958
2023-01,7503 - State Personnel Board,54,13,2,0,0,2,71
2023-01,7504 - Office of Data and Innovation,37,0,2,0,0,0,39
2023-01,7600 - California Department of Tax and Fee Administration,2444,716,375,101,19,18,3673
2023-01,7730 - Franchise Tax Board,182,230,3324,908,129,427,5200
2023-01,7760 - Department of General Services,868,227,217,322,55,335,2024
2023-01,7870 - California Victim Compensation Board,0,198,15,12,0,2,227
2023-01,7900 - Public Employees' Retirement System,268,9,14,1898,35,84,2308
2023-01,7910 - Office of Administrative Law,2,7,6,6,2,0,23
2023-01,7920 - State Teachers' Retirement System,3,37,977,217,8,0,1242
2023-01,8120 - Commission on Peace Officer Standards and Training,11,0,0,138,2,3,154
2023-01,8140 - State Public Defender,48,5,13,10,1,12,89
2023-01,8560 - California Exposition and State Fair,0,0,0,0,0,0,0
2023-01,8570 - Department of Food and Agriculture,154,129,91,58,36,96,564
2023-01,8620 - Fair Political Practices Commission,60,17,11,2,0,1,91
2023-01,8660 - Public Utilities Commission,1128,80,56,35,14,2,1315
2023-01,"8780 - Milton Marks ""Little Hoover"" Commission on California State Government Organization and Economy",4,0,1,0,0,0,5
2023-01,"8830 - Law Revision Commission, California",8,0,0,0,0,0,8
2023-01,8860 - Department of Finance,39,28,279,27,7,7,387
2023-01,8880 - Financial Information System for California,273,20,6,3,0,1,303
2023-01,"8885 - States Mandates, Commission on",10,2,0,3,0,0,15
2023-01,8940 - Military Department,4,11,52,27,6,1,101
2023-01,8955 - Department of Veterans Affairs,125,92,128,66,18,37,466
2023-01,A059 - California Correctional Health Care Services,970,331,534,521,414,2,2772
2023-01,A279 - Unemployment Insurance Appeals Board,73,69,41,28,19,158,388
2023-01,A281 - Employment Training Panel,5,38,10,12,9,0,74
2023-01,A314 - California Science Center,3,0,0,22,3,5,33
2023-01,A341 - California Earthquake Authority,50,6,7,2,0,0,65
2023-01,A424 - Cradle-to-Career,4,0,5,0,0,0,9
2023-01,A541 - Board of Forestry and Fire Protection,2,4,3,0,0,0,9
2023-02,0500 - Governor's Office,12,13,39,31,10,28,133
2023-02,0509 - Governor's Office of Business and Economic Development (GO-Biz),102,13,19,5,6,0,145
2023-02,0511 - Secretary for Government Operations Agency,0,12,9,2,0,0,23
2023-02,"0515 - Secretary for Business, Consumer Services, and Housing Agency",42,8,5,6,3,1,65
2023-02,0521 - Secretary for Transportation Agency,0,0,16,3,0,0,19
2023-02,0530 - Secretary for California Health and Human Services Agency,51,11,6,11,2,0,81
2023-02,0531 - Office of Systems Integration,343,16,10,1,2,6,378
2023-02,0540 - Secretary of the Natural Resources Agency,74,0,10,2,2,1,89
2023-02,0552 - Office of the Inspector General,117,7,7,3,3,7,144
2023-02,0555 - Secretary for Environmental Protection,38,6,3,2,2,34,85
2023-02,0559 - Secretary for Labor and Workforce Development Agency,4,3,7,11,2,5,32
2023-02,0650 - Office of Planning and Research,123,38,22,11,0,2,196
2023-02,0690 - Governor's Office of Emergency Services,29,263,182,203,179,311,1167
2023-02,0820 - Department of Justice,1704,628,690,581,292,42,3937
2023-02,0840 - State Controller,726,152,122,71,39,62,1172
2023-02,0845 - Department of Insurance,532,214,61,32,175,3,1017
2023-02,0855 - California Gambling Control Commission,26,8,8,0,0,0,42
2023-02,0860 - State Board of Equalization,19,4,114,15,1,0,153
2023-02,0870 - Office of Tax Appeals,26,16,39,8,3,2,94
2023-02,0911 - Citizens Redistricting Commission,3,1,1,0,0,0,5
2023-02,1045 - Cannabis Control Appeals Panel,5,1,0,1,0,1,8
2023-02,1111 - Department of Consumer Affairs,586,516,455,442,315,223,2537
2023-02,1115 - Department of Cannabis Control,218,38,47,24,65,0,392
2023-02,1700 - California Civil Rights Department,205,35,19,3,1,4,267
2023-02,1701 - Department of Financial Protection and Innovation,551,61,16,62,6,1,697
2023-02,1703 - California Privacy Protection Agency,22,0,1,0,0,0,23
2023-02,1750 - California Horse Racing Board,10,2,7,0,5,1,25
2023-02,2100 - Department of Alcoholic Beverage Control,48,29,59,90,134,114,474
2023-02,2120 - Alcoholic Beverage Control Appeals Board,2,1,2,1,0,0,6
2023-02,2240 - Department of Housing and Community Development,706,94,94,97,20,94,1105
2023-02,2320 - Department of Real Estate,27,122,115,25,10,6,305
2023-02,2600 - California Transportation Commission,22,2,10,2,1,0,37
2023-02,2660 - Department of Transportation,2913,2941,6033,1314,374,105,13680
2023-02,2665 - High-Speed Rail Authority,187,63,42,26,28,6,352
2023-02,2700 - California Traffic Safety Program,2,21,8,1,0,0,32
2023-02,2720 - California Highway Patrol,0,114,0,141,0,1171,1426
2023-02,2740 - Department of Motor Vehicles,506,121,381,243,60,441,1752
2023-02,3100 - Exposition Park,0,0,0,8,0,1,9
2023-02,3105 - California African-American Museum,0,0,0,0,16,0,16
2023-02,3125 - California Tahoe Conservancy,18,4,6,11,1,6,46
2023-02,3340 - California Conservation Corps,40,32,30,24,16,0,142
2023-02,3355 - Office of Energy Infrastructure Safety,64,0,0,0,0,1,65
2023-02,3360 - Energy Resources Conservation and Development Commission,609,49,25,9,7,0,699
2023-02,3480 - Department of Conservation,404,58,91,53,11,33,650
2023-02,3540 - Department of Forestry and Fire Protection,191,142,148,143,53,6,683
2023-02,3560 - State Lands Commission,89,26,15,14,6,29,179
2023-02,3600 - Department of Fish and Wildlife,80,942,307,269,102,296,1996
2023-02,3640 - Wildlife Conservation Board,18,3,3,2,0,10,36
2023-02,3720 - California Coastal Commission,48,68,42,10,6,2,176
2023-02,3760 - State Coastal Conservancy,43,18,2,2,0,0,65
2023-02,3780 - Native American Heritage Commission,0,1,4,2,1,0,8
2023-02,3790 - Department of Parks and Recreation,188,186,179,130,35,749,1467
2023-02,3810 - Santa Monica Mountains Conservancy,6,0,0,0,0,0,6
2023-02,3820 - San Francisco Bay Conservation and Development Commission,0,45,1,1,0,0,47
2023-02,3825 - San Gabriel and Lower Los Angeles Rivers and Mountains Conservancy,1,7,1,0,0,0,9
2023-02,3830 - San Joaquin River Conservancy,2,2,0,0,0,0,4
2023-02,3835 - Baldwin Hills Conservancy,0,1,2,1,0,0,4
2023-02,3840 - Delta Protection Commission,2,0,2,0,1,2,7
2023-02,3845 - San Diego River Conservancy,0,0,0,0,0,3,3
2023-02,3850 - Coachella Valley Mountains Conservancy,0,0,1,1,2,0,4
2023-02,3855 - Sierra Nevada Conservancy,18,9,14,7,0,0,48
2023-02,3860 - Department of Water Resources,187,405,977,640,129,33,2371
2023-02,3862 - Central Valley Flood Protection Board,22,22,13,1,6,0,64
2023-02,3875 - Sacramento-San Joaquin Delta Conservancy,12,4,1,0,0,0,17
2023-02,3885 - Delta Stewardship Council,43,10,6,2,1,0,62
2023-02,3900 - State Air Resources Board,41,857,149,145,273,133,1598
2023-02,3930 - Department of Pesticide Regulation,194,98,82,31,9,0,414
2023-02,3940 - State Water Resources Control Board,1186,587,267,347,49,127,2563
2023-02,3960 - Department of Toxic Substances Control,712,155,101,138,34,79,1219
2023-02,3970 - Department of Resources Recycling and Recovery,399,90,39,20,13,1,562
2023-02,3980 - Office of Environmental Health Hazard Assessment,108,20,5,1,0,0,134
2023-02,4100 - State Council on Developmental Disabilities,29,5,16,5,7,3,65
2023-02,4140 - Department of Health Care Access and Information,230,49,32,113,10,69,503
2023-02,4150 - Department of Managed Health Care,537,5,6,0,0,0,548
2023-02,4170 - Department of Aging,198,23,15,8,0,1,245
2023-02,4250 - California Children and Families Commission,1,0,37,1,0,0,39
2023-02,4260 - State Department of Health Care Services,1981,1039,294,122,31,610,4077
2023-02,4265 - Department of Public Health,2456,137,112,83,24,1126,3938
2023-02,4300 - Department of Developmental Services,404,99,41,40,15,19,618
2023-02,4440 - Department of State Hospitals,386,226,150,182,380,0,1324
2023-02,4560 - Mental Health Services Oversight and Accountability Commission,7,15,10,8,3,8,51
2023-02,4700 - Department of Community Services and Development,109,3,4,2,0,1,119
2023-02,4800 - California Health Benefit Exchange,1157,62,56,26,4,0,1305
2023-02,5160 - Department of Rehabilitation,238,228,483,401,133,149,1632
2023-02,5170 - State Independent Living Council,2,0,0,0,0,0,2
2023-02,5175 - Department of Child Support Services,458,91,10,11,13,0,583
2023-02,5180 - Department of Social Services,1716,587,374,1404,406,6,4493
2023-02,5225 - Department of Corrections and Rehabilitation,1212,311,304,429,244,3164,5664
2023-02,5227 - Board of State and Community Corrections,8,86,6,1,2,11,114
2023-02,5420 - Prison Industry Authority,11,42,95,44,4,18,214
2023-02,6100 - Department of Education,904,93,85,20,16,187,1305
2023-02,6120 - California State Library,58,23,18,28,22,3,152
2023-02,6125 - Education Audit Appeals Panel,0,2,1,0,0,0,3
2023-02,6200 - California School for the Blind,0,0,2,1,2,17,22
2023-02,6250 - California School for the Deaf - Riverside,0,2,2,5,3,5,17
2023-02,6260 - Diagnostic Centers,0,0,0,3,1,22,26
2023-02,6360 - Commission on Teacher Credentialing,23,84,25,21,8,21,182
2023-02,6870 - Board of Governors of the California Community Colleges,174,3,6,1,0,0,184
2023-02,"6980 - Student Aid Commission, California",90,21,10,1,1,5,128
2023-02,7100 - Employment Development Department,5092,700,768,391,235,34,7220
2023-02,7120 - California Workforce Development Board,69,0,0,0,0,0,69
2023-02,7300 - Agricultural Labor Relations Board,8,6,37,5,0,9,65
2023-02,7320 - Public Employment Relations Board,8,26,19,5,3,2,63
2023-02,7501 - Department of Human Resources,146,53,62,10,7,4,282
2023-02,7502 - California Department of Technology,784,48,32,7,6,87,964
2023-02,7503 - State Personnel Board,53,13,3,0,0,2,71
2023-02,7504 - Office of Data and Innovation,36,5,2,0,0,0,43
2023-02,7600 - California Department of Tax and Fee Administration,2423,718,391,83,13,20,3648
2023-02,7730 - Franchise Tax Board,183,218,3331,911,127,464,5234
2023-02,7760 - Department of General Services,895,232,216,318,31,346,2038
2023-02,7870 - California Victim Compensation Board,0,199,15,10,0,2,226
2023-02,7900 - Public Employees' Retirement System,265,10,14,1899,35,84,2307
2023-02,7910 - Office of Administrative Law,2,7,6,6,2,0,23
2023-02,7920 - State Teachers' Retirement System,3,35,990,213,9,8,1258
2023-02,8120 - Commission on Peace Officer Standards and Training,12,0,0,140,2,5,159
2023-02,8140 - State Public Defender,48,5,13,10,1,12,89
2023-02,8560 - California Exposition and State Fair,0,0,0,0,0,0,0
2023-02,8570 - Department of Food and Agriculture,150,120,85,49,27,84,515
2023-02,8620 - Fair Political Practices Commission,60,17,11,2,0,1,91
2023-02,8660 - Public Utilities Commission,1102,87,46,54,6,23,1318
2023-02,"8780 - Milton Marks ""Little Hoover"" Commission on California State Government Organization and Economy",0,4,3,0,0,0,7
2023-02,"8830 - Law Revision Commission, California",8,0,0,0,0,0,8
2023-02,8860 - Department of Finance,39,28,277,27,7,7,385
2023-02,8880 - Financial Information System for California,273,23,10,2,1,1,310
2023-02,"8885 - States Mandates, Commission on",10,2,0,3,0,0,15
2023-02,8940 - Military Department,4,11,52,28,10,1,106
2023-02,8955 - Department of Veterans Affairs,125,103,126,63,20,36,473
2023-02,A059 - California Correctional Health Care Services,966,325,506,502,552,34,2885
2023-02,A279 - Unemployment Insurance Appeals Board,73,67,61,29,19,145,394
2023-02,A281 - Employment Training Panel,5,38,10,12,9,0,74
2023-02,A314 - California Science Center,3,0,0,22,3,6,34
2023-02,A341 - California Earthquake Authority,50,6,7,2,0,0,65
2023-02,A424 - Cradle-to-Career,4,0,6,0,0,0,10
2023-02,A541 - Board of Forestry and Fire Protection,2,4,3,0,1,0,10
2023-03,0500 - Governor's Office,12,13,39,28,10,30,132
2023-03,0509 - Governor's Office of Business and Economic Development (GO-Biz),104,13,19,5,6,1,148
2023-03,0511 - Secretary for Government Operations Agency,0,8,16,1,0,0,25
2023-03,"0515 - Secretary for Business, Consumer Services, and Housing Agency",43,7,5,6,3,1,65
2023-03,0521 - Secretary for Transportation Agency,0,0,16,3,0,0,19
2023-03,0530 - Secretary for California Health and Human Services Agency,56,12,7,11,2,1,89
2023-03,0531 - Office of Systems Integration,350,16,10,1,2,5,384
2023-03,0540 - Secretary of the Natural Resources Agency,69,0,16,2,2,1,90
2023-03,0552 - Office of the Inspector General,117,7,6,4,3,6,143
2023-03,0555 - Secretary for Environmental Protection,38,6,3,2,2,35,86
2023-03,0559 - Secretary for Labor and Workforce Development Agency,4,3,7,11,5,4,34
2023-03,0650 - Office of Planning and Research,126,39,23,12,0,2,202
2023-03,0690 - Governor's Office of Emergency Services,30,225,180,191,191,440,1257
2023-03,0820 - Department of Justice,1670,618,682,556,257,466,4249
2023-03,0840 - State Controller,723,160,140,76,37,54,1190
2023-03,0845 - Department of Insurance,534,208,61,31,177,3,1014
2023-03,0855 - California Gambling Control Commission,25,8,8,0,0,0,41
2023-03,0860 - State Board of Equalization,16,4,125,10,1,0,156
2023-03,0870 - Office of Tax Appeals,25,21,34,7,3,0,90
2023-03,0911 - Citizens Redistricting Commission,3,1,1,0,0,0,5
2023-03,1045 - Cannabis Control Appeals Panel,5,1,0,1,0,1,8
2023-03,1111 - Department of Consumer Affairs,586,516,455,442,315,223,2537
2023-03,1115 - Department of Cannabis Control,226,39,45,25,69,0,404
2023-03,1700 - California Civil Rights Department,202,35,19,3,1,4,264
2023-03,1701 - Department of Financial Protection and Innovation,557,63,18,62,6,0,706
2023-03,1703 - California Privacy Protection Agency,21,0,1,0,0,0,22
2023-03,1750 - California Horse Racing Board,10,2,8,0,5,1,26
2023-03,2100 - Department of Alcoholic Beverage Control,52,31,57,92,139,103,474
2023-03,2120 - Alcoholic Beverage Control Appeals Board,2,1,2,1,0,0,6
2023-03,2240 - Department of Housing and Community Development,734,91,86,92,23,87,1113
2023-03,2320 - Department of Real Estate,26,121,115,25,11,7,305
2023-03,2600 - California Transportation Commission,22,2,10,2,1,0,37
2023-03,2660 - Department of Transportation,2307,2307,7070,1255,491,17,13447
2023-03,2665 - High-Speed Rail Authority,192,65,41,26,27,7,358
2023-03,2700 - California Traffic Safety Program,2,21,9,1,0,0,33
2023-03,2720 - California Highway Patrol,0,126,0,224,0,1081,1431
2023-03,2740 - Department of Motor Vehicles,506,126,408,258,61,381,1740
2023-03,3100 - Exposition Park,1,0,0,7,0,1,9
2023-03,3105 - California African-American Museum,0,0,0,0,16,0,16
2023-03,3125 - California Tahoe Conservancy,18,4,6,11,1,6,46
2023-03,3340 - California Conservation Corps,41,29,34,25,15,0,144
2023-03,3355 - Office of Energy Infrastructure Safety,71,0,0,0,0,0,71
2023-03,3360 - Energy Resources Conservation and Development Commission,611,49,25,9,7,0,701
2023-03,3480 - Department of Conservation,408,59,94,54,11,35,661
2023-03,3540 - Department of Forestry and Fire Protection,194,146,151,146,56,4,697
2023-03,3560 - State Lands Commission,90,24,15,13,6,30,178
2023-03,3600 - Department of Fish and Wildlife,69,953,301,269,100,319,2011
2023-03,3640 - Wildlife Conservation Board,19,4,3,2,0,8,36
2023-03,3720 - California Coastal Commission,48,69,43,10,6,2,178
2023-03,3760 - State Coastal Conservancy,43,18,2,2,0,0,65
2023-03,3780 - Native American Heritage Commission,0,1,4,2,1,0,8
2023-03,3790 - Department of Parks and Recreation,180,184,176,134,34,718,1426
2023-03,3810 - Santa Monica Mountains Conservancy,6,0,0,0,0,0,6
2023-03,3820 - San Francisco Bay Conservation and Development Commission,0,46,2,1,0,0,49
2023-03,3825 - San Gabriel and Lower Los Angeles Rivers and Mountains Conservancy,1,7,1,0,0,0,9
2023-03,3830 - San Joaquin River Conservancy,2,2,0,0,0,0,4
2023-03,3835 - Baldwin Hills Conservancy,0,1,2,1,0,0,4
2023-03,3840 - Delta Protection Commission,2,0,2,0,1,2,7
2023-03,3845 - San Diego River Conservancy,0,0,0,0,0,3,3
2023-03,3850 - Coachella Valley Mountains Conservancy,0,0,1,1,2,0,4
2023-03,3855 - Sierra Nevada Conservancy,20,7,16,5,1,0,49
2023-03,3860 - Department of Water Resources,192,401,1020,652,134,34,2433
2023-03,3862 - Central Valley Flood Protection Board,20,19,9,1,6,0,55
2023-03,3875 - Sacramento-San Joaquin Delta Conservancy,11,6,0,0,0,0,17
2023-03,3885 - Delta Stewardship Council,41,10,6,3,1,0,61
2023-03,3900 - State Air Resources Board,41,850,149,143,269,135,1587
2023-03,3930 - Department of Pesticide Regulation,195,98,83,31,9,1,417
2023-03,3940 - State Water Resources Control Board,1015,601,248,323,43,161,2391
2023-03,3960 - Department of Toxic Substances Control,664,141,94,135,31,73,1138
2023-03,3970 - Department of Resources Recycling and Recovery,401,95,36,22,12,1,567
2023-03,3980 - Office of Environmental Health Hazard Assessment,108,20,5,1,0,0,134
2023-03,4100 - State Council on Developmental Disabilities,29,5,16,5,7,3,65
2023-03,4140 - Department of Health Care Access and Information,246,46,33,112,9,69,515
2023-03,4150 - Department of Managed Health Care,537,5,6,0,0,0,548
2023-03,4170 - Department of Aging,199,25,16,8,0,1,249
2023-03,4250 - California Children and Families Commission,1,0,35,0,0,0,36
2023-03,4260 - State Department of Health Care Services,1492,1467,246,153,27,704,4089
2023-03,4265 - Department of Public Health,2456,137,112,83,24,1126,3938
2023-03,4300 - Department of Developmental Services,420,100,48,40,11,6,625
2023-03,4440 - Department of State Hospitals,386,226,150,182,380,0,1324
2023-03,4560 - Mental Health Services Oversight and Accountability Commission,7,14,10,7,3,8,49
2023-03,4700 - Department of Community Services and Development,108,3,4,2,0,1,118
2023-03,4800 - California Health Benefit Exchange,1145,63,52,28,4,19,1311
2023-03,5160 - Department of Rehabilitation,238,231,490,413,135,148,1655
2023-03,5170 - State Independent Living Council,2,0,0,0,0,0,2
2023-03,5175 - Department of Child Support Services,460,94,9,12,13,0,588
2023-03,5180 - Department of Social Services,1710,590,363,1400,401,5,4469
2023-03,5225 - Department of Corrections and Rehabilitation,1648,395,544,688,427,927,4629
2023-03,5227 - Board of State and Community Corrections,8,86,6,1,2,11,114
2023-03,5420 - Prison Industry Authority,11,42,93,47,5,17,215
2023-03,6100 - Department of Education,921,94,87,22,15,194,1333
2023-03,6120 - California State Library,65,17,18,31,22,3,156
2023-03,6125 - Education Audit Appeals Panel,0,2,1,0,0,0,3
2023-03,6200 - California School for the Blind,0,0,2,1,3,16,22
2023-03,6240 - California School for the Deaf - Fremont,4,0,0,0,0,0,4
2023-03,6250 - California School for the Deaf - Riverside,0,2,2,5,3,5,17
2023-03,6260 - Diagnostic Centers,0,0,0,3,1,22,26
2023-03,6360 - Commission on Teacher Credentialing,24,84,24,24,8,18,182
2023-03,6870 - Board of Governors of the California Community Colleges,176,3,5,1,0,0,185
2023-03,"6980 - Student Aid Commission, California",90,21,10,1,1,5,128
2023-03,7100 - Employment Development Department,5125,716,797,396,254,42,7330
2023-03,7120 - California Workforce Development Board,83,0,0,0,0,0,83
2023-03,7300 - Agricultural Labor Relations Board,6,5,37,4,0,9,61
2023-03,7320 - Public Employment Relations Board,9,25,18,5,3,2,62
2023-03,7501 - Department of Human Resources,141,59,66,10,13,5,294
2023-03,7502 - California Department of Technology,783,57,32,8,6,77,963
2023-03,7503 - State Personnel Board,51,15,4,0,0,1,71
2023-03,7504 - Office of Data and Innovation,36,5,2,0,0,0,43
2023-03,7600 - California Department of Tax and Fee Administration,2410,734,394,81,13,25,3657
2023-03,7730 - Franchise Tax Board,170,212,3333,916,126,429,5186
2023-03,7760 - Department of General Services,895,232,220,317,29,356,2049
2023-03,7870 - California Victim Compensation Board,0,199,15,10,0,2,226
2023-03,7900 - Public Employees' Retirement System,260,8,11,1818,123,86,2306
2023-03,7910 - Office of Administrative Law,2,7,6,7,2,0,24
2023-03,7920 - State Teachers' Retirement System,5,36,991,208,11,8,1259
2023-03,8120 - Commission on Peace Officer Standards and Training,13,0,0,147,2,3,165
2023-03,8140 - State Public Defender,48,6,15,12,1,7,89
2023-03,8560 - California Exposition and State Fair,0,0,0,0,0,0,0
2023-03,8570 - Department of Food and Agriculture,113,89,79,49,22,61,413
2023-03,8620 - Fair Political Practices Commission,61,17,10,2,0,1,91
2023-03,8660 - Public Utilities Commission,1096,87,46,54,6,23,1312
2023-03,"8780 - Milton Marks ""Little Hoover"" Commission on California State Government Organization and Economy",0,4,3,0,0,0,7
2023-03,8825 - Commission on Asian and Pacific Islander American Affairs,3,0,0,0,0,0,3
2023-03,"8830 - Law Revision Commission, California",8,0,0,0,0,0,8
2023-03,8860 - Department of Finance,39,28,275,27,7,7,383
2023-03,8880 - Financial Information System for California,277,24,10,0,8,2,321
2023-03,"8885 - States Mandates, Commission on",10,2,0,3,0,0,15
2023-03,8940 - Military Department,4,11,52,29,8,1,105
2023-03,8955 - Department of Veterans Affairs,126,103,129,62,21,36,477
2023-03,A059 - California Correctional Health Care Services,969,329,535,535,621,32,3021
2023-03,A279 - Unemployment Insurance Appeals Board,65,59,77,31,21,142,395
2023-03,A281 - Employment Training Panel,5,38,10,12,9,0,74
2023-03,A314 - California Science Center,3,0,0,22,3,6,34
2023-03,A341 - California Earthquake Authority,50,6,7,2,0,0,65
2023-03,A424 - Cradle-to-Career,6,0,6,0,0,0,12
2023-03,A541 - Board of Forestry and Fire Protection,2,3,3,0,1,0,9
2023-04,0500 - Governor's Office,12,12,40,29,9,28,130
2023-04,0509 - Governor's Office of Business and Economic Development (GO-Biz),105,14,20,4,7,0,150
2023-04,0511 - Secretary for Government Operations Agency,0,8,16,2,0,0,26
2023-04,"0515 - Secretary for Business, Consumer Services, and Housing Agency",47,7,6,6,3,1,70
2023-04,0521 - Secretary for Transportation Agency,0,0,16,3,0,0,19
2023-04,0530 - Secretary for California Health and Human Services Agency,56,12,7,11,2,1,89
2023-04,0531 - Office of Systems Integration,360,16,9,1,2,5,393
2023-04,0540 - Secretary of the Natural Resources Agency,70,0,16,2,2,1,91
2023-04,0552 - Office of the Inspector General,117,7,7,3,3,6,143
2023-04,0555 - Secretary for Environmental Protection,38,6,3,2,2,33,84
2023-04,0559 - Secretary for Labor and Workforce Development Agency,4,3,7,11,5,5,35
2023-04,0650 - Office of Planning and Research,128,41,24,12,0,2,207
2023-04,0690 - Governor's Office of Emergency Services,329,83,138,245,75,0,870
2023-04,0820 - Department of Justice,1715,620,667,579,335,397,4313
2023-04,0840 - State Controller,727,162,138,82,39,46,1194
2023-04,0845 - Department of Insurance,542,206,61,31,174,3,1017
2023-04,0855 - California Gambling Control Commission,26,8,8,0,0,0,42
2023-04,0860 - State Board of Equalization,19,5,116,14,1,0,155
2023-04,0870 - Office of Tax Appeals,25,21,36,7,3,0,92
2023-04,0890 - Secretary of State,139,66,115,51,34,86,491
2023-04,0911 - Citizens Redistricting Commission,3,1,1,0,0,0,5
2023-04,1045 - Cannabis Control Appeals Panel,5,1,0,1,0,1,8
2023-04,1111 - Department of Consumer Affairs,586,516,455,442,315,223,2537
2023-04,1115 - Department of Cannabis Control,228,39,45,24,73,0,409
2023-04,1700 - California Civil Rights Department,192,33,17,3,1,4,250
2023-04,1701 - Department of Financial Protection and Innovation,564,64,18,62,7,0,715
2023-04,1703 - California Privacy Protection Agency,22,0,1,0,0,0,23
2023-04,1750 - California Horse Racing Board,11,2,7,0,5,1,26
2023-04,2100 - Department of Alcoholic Beverage Control,52,31,57,91,141,101,473
2023-04,2120 - Alcoholic Beverage Control Appeals Board,2,0,3,1,0,0,6
2023-04,2240 - Department of Housing and Community Development,734,97,79,76,24,95,1105
2023-04,2600 - California Transportation Commission,22,2,10,2,1,0,37
2023-04,2660 - Department of Transportation,2307,2307,7070,1255,491,17,13447
2023-04,2665 - High-Speed Rail Authority,199,57,47,30,25,0,358
2023-04,2700 - California Traffic Safety Program,2,21,9,1,0,0,33
2023-04,2720 - California Highway Patrol,0,137,0,259,0,1038,1434
2023-04,2740 - Department of Motor Vehicles,504,121,421,260,57,373,1736
2023-04,3100 - Exposition Park,0,0,0,9,0,0,9
2023-04,3105 - California African-American Museum,0,0,0,0,16,0,16
2023-04,3125 - California Tahoe Conservancy,18,4,6,11,1,6,46
2023-04,3340 - California Conservation Corps,40,30,36,28,15,0,149
2023-04,3355 - Office of Energy Infrastructure Safety,79,0,0,0,0,0,79
2023-04,3360 - Energy Resources Conservation and Development Commission,614,50,28,9,7,0,708
2023-04,3480 - Department of Conservation,407,59,92,57,11,34,660
2023-04,3540 - Department of Forestry and Fire Protection,197,149,150,154,57,4,711
2023-04,3560 - State Lands Commission,90,24,15,14,6,27,176
2023-04,3600 - Department of Fish and Wildlife,69,945,304,269,99,340,2026
2023-04,3640 - Wildlife Conservation Board,19,4,3,2,0,14,42
2023-04,3720 - California Coastal Commission,48,70,43,10,6,2,179
2023-04,3760 - State Coastal Conservancy,43,19,2,2,0,0,66
2023-04,3780 - Native American Heritage Commission,0,1,4,2,1,0,8
2023-04,3790 - Department of Parks and Recreation,230,223,237,143,55,760,1648
2023-04,3810 - Santa Monica Mountains Conservancy,6,0,0,0,0,0,6
2023-04,3820 - San Francisco Bay Conservation and Development Commission,0,47,2,1,0,0,50
2023-04,3825 - San Gabriel and Lower Los Angeles Rivers and Mountains Conservancy,0,10,0,0,0,0,10
2023-04,3830 - San Joaquin River Conservancy,2,2,0,0,0,0,4
2023-04,3835 - Baldwin Hills Conservancy,0,1,2,1,0,0,4
2023-04,3840 - Delta Protection Commission,2,0,2,0,1,2,7
2023-04,3845 - San Diego River Conservancy,0,0,0,0,0,3,3
2023-04,3850 - Coachella Valley Mountains Conservancy,0,0,1,1,2,0,4
2023-04,3855 - Sierra Nevada Conservancy,19,9,14,6,1,0,49
2023-04,3860 - Department of Water Resources,150,389,917,597,126,4,2183
2023-04,3862 - Central Valley Flood Protection Board,19,16,7,1,6,0,49
2023-04,3875 - Sacramento-San Joaquin Delta Conservancy,16,0,2,0,0,0,18
2023-04,3885 - Delta Stewardship Council,38,10,7,2,1,0,58
2023-04,3900 - State Air Resources Board,79,841,148,144,268,130,1610
2023-04,3930 - Department of Pesticide Regulation,192,102,90,25,8,2,419
2023-04,3940 - State Water Resources Control Board,1003,571,331,329,52,61,2347
2023-04,3960 - Department of Toxic Substances Control,649,137,66,122,25,9,1008
2023-04,3980 - Office of Environmental Health Hazard Assessment,108,20,5,1,0,0,134
2023-04,4100 - State Council on Developmental Disabilities,29,5,16,5,7,3,65
2023-04,4140 - Department of Health Care Access and Information,256,44,31,112,9,70,522
2023-04,4150 - Department of Managed Health Care,540,5,6,0,0,0,551
2023-04,4170 - Department of Aging,198,29,16,9,0,1,253
2023-04,4250 - California Children and Families Commission,1,0,34,0,0,0,35
2023-04,4260 - State Department of Health Care Services,2023,1075,303,128,30,522,4081
2023-04,4265 - Department of Public Health,2456,137,112,83,2,1126,3916
2023-04,4300 - Department of Developmental Services,431,100,48,41,10,4,634
2023-04,4440 - Department of State Hospitals,405,227,164,179,416,1,1392
2023-04,4560 - Mental Health Services Oversight and Accountability Commission,7,14,10,7,3,8,49
2023-04,4700 - Department of Community Services and Development,108,3,4,2,0,0,117
2023-04,4800 - California Health Benefit Exchange,1143,66,52,27,1,20,1309
2023-04,5160 - Department of Rehabilitation,239,227,482,402,134,133,1617
2023-04,5170 - State Independent Living Council,2,0,0,0,0,0,2
2023-04,5175 - Department of Child Support Services,454,97,9,11,12,0,583
2023-04,5180 - Department of Social Services,1729,595,362,1387,401,5,4479
2023-04,5225 - Department of Corrections and Rehabilitation,1659,404,552,686,430,913,4644
2023-04,5227 - Board of State and Community Corrections,8,87,6,1,2,11,115
2023-04,5420 - Prison Industry Authority,13,44,88,54,2,19,220
2023-04,6100 - Department of Education,915,94,89,22,15,199,1334
2023-04,6120 - California State Library,72,17,15,32,22,3,161
2023-04,6125 - Education Audit Appeals Panel,0,2,1,0,0,0,3
2023-04,6200 - California School for the Blind,0,0,2,1,3,16,22
2023-04,6240 - California School for the Deaf - Fremont,4,0,0,0,0,0,4
2023-04,6250 - California School for the Deaf - Riverside,0,2,2,5,3,5,17
2023-04,6260 - Diagnostic Centers,0,0,0,3,1,22,26
2023-04,6360 - Commission on Teacher Credentialing,24,87,24,28,7,17,187
2023-04,6870 - Board of Governors of the California Community Colleges,177,3,3,1,0,0,184
2023-04,"6980 - Student Aid Commission, California",90,21,10,1,1,5,128
2023-04,7100 - Employment Development Department,5152,726,795,401,252,43,7369
2023-04,7120 - California Workforce Development Board,83,0,0,0,0,0,83
2023-04,7300 - Agricultural Labor Relations Board,5,5,37,4,0,9,60
2023-04,7320 - Public Employment Relations Board,9,24,19,5,3,2,62
2023-04,7501 - Department of Human Resources,125,60,73,13,12,3,286
2023-04,7502 - California Department of Technology,398,434,46,8,23,68,977
2023-04,7503 - State Personnel Board,51,12,4,0,0,2,69
2023-04,7504 - Office of Data and Innovation,37,4,2,0,0,0,43
2023-04,7600 - California Department of Tax and Fee Administration,2363,731,402,85,28,26,3635
2023-04,7730 - Franchise Tax Board,168,209,3336,921,129,434,5197
2023-04,7760 - Department of General Services,889,223,243,321,29,357,2062
2023-04,7870 - California Victim Compensation Board,0,198,15,10,0,3,226
2023-04,7900 - Public Employees' Retirement System,260,4,10,1913,38,77,2302
2023-04,7910 - Office of Administrative Law,2,7,6,7,2,0,24
2023-04,7920 - State Teachers' Retirement System,6,38,1001,204,9,6,1264
2023-04,8120 - Commission on Peace Officer Standards and Training,13,0,0,148,2,3,166
2023-04,8140 - State Public Defender,49,6,15,12,1,6,89
2023-04,8560 - California Exposition and State Fair,0,0,0,0,0,0,0
2023-04,8570 - Department of Food and Agriculture,9,24,11,12,9,23,88
2023-04,8620 - Fair Political Practices Commission,61,17,12,2,0,1,93
2023-04,8660 - Public Utilities Commission,1096,87,46,54,6,23,1312
2023-04,"8780 - Milton Marks ""Little Hoover"" Commission on California State Government Organization and Economy",0,4,3,0,0,0,7
2023-04,8825 - Commission on Asian and Pacific Islander American Affairs,3,0,0,0,0,0,3
2023-04,"8830 - Law Revision Commission, California",8,0,0,0,0,0,8
2023-04,8860 - Department of Finance,38,28,278,27,6,8,385
2023-04,8880 - Financial Information System for California,278,25,15,2,0,0,320
2023-04,"8885 - States Mandates, Commission on",9,1,1,3,0,0,14
2023-04,8940 - Military Department,4,11,55,28,7,1,106
2023-04,8955 - Department of Veterans Affairs,128,99,124,60,18,38,467
2023-04,A059 - California Correctional Health Care Services,968,329,534,556,623,34,3044
2023-04,A279 - Unemployment Insurance Appeals Board,66,60,78,28,23,142,397
2023-04,A281 - Employment Training Panel,5,38,10,12,9,0,74
2023-04,A314 - California Science Center,3,0,0,22,3,6,34
2023-04,A341 - California Earthquake Authority,52,6,8,2,1,0,69
2023-04,A424 - Cradle-to-Career,7,0,6,0,0,0,13
2023-04,A541 - Board of Forestry and Fire Protection,2,3,3,0,1,0,9
2023-05,0500 - Governor's Office,13,12,40,32,9,28,134
2023-05,0509 - Governor's Office of Business and Economic Development (GO-Biz),103,16,19,5,7,0,150
2023-05,0511 - Secretary for Government Operations Agency,0,7,19,1,0,0,27
2023-05,0521 - Secretary for Transportation Agency,0,0,16,3,0,0,19
2023-05,0530 - Secretary for California Health and Human Services Agency,59,12,7,10,2,1,91
2023-05,0531 - Office of Systems Integration,355,17,9,1,2,5,389
2023-05,0540 - Secretary of the Natural Resources Agency,69,0,16,2,2,1,90
2023-05,0552 - Office of the Inspector General,118,7,7,1,4,6,143
2023-05,0555 - Secretary for Environmental Protection,39,6,3,2,2,33,85
2023-05,0559 - Secretary for Labor and Workforce Development Agency,4,3,7,11,6,5,36
2023-05,0650 - Office of Planning and Research,129,40,25,13,0,2,209
2023-05,0690 - Governor's Office of Emergency Services,292,71,131,270,65,0,829
2023-05,0820 - Department of Justice,1684,609,668,566,339,360,4226
2023-05,0840 - State Controller,730,162,135,80,35,52,1194
2023-05,0845 - Department of Insurance,548,212,64,26,166,5,1021
2023-05,0855 - California Gambling Control Commission,26,8,8,0,0,0,42
2023-05,0860 - State Board of Equalization,19,5,119,10,1,2,156
2023-05,0870 - Office of Tax Appeals,25,21,37,7,3,0,93
2023-05,0911 - Citizens Redistricting Commission,3,1,1,0,0,0,5
2023-05,1045 - Cannabis Control Appeals Panel,5,1,0,1,0,1,8
2023-05,1111 - Department of Consumer Affairs,528,571,409,492,313,220,2533
2023-05,1115 - Department of Cannabis Control,225,38,45,20,81,0,409
2023-05,1700 - California Civil Rights Department,202,35,19,3,1,4,264
2023-05,1701 - Department of Financial Protection and Innovation,565,66,19,61,7,0,718
2023-05,1703 - California Privacy Protection Agency,23,0,1,0,0,0,24
2023-05,1750 - California Horse Racing Board,11,2,7,0,5,1,26
2023-05,2100 - Department of Alcoholic Beverage Control,52,31,57,90,142,101,473
2023-05,2120 - Alcoholic Beverage Control Appeals Board,2,0,3,1,0,0,6
2023-05,2240 - Department of Housing and Community Development,742,98,84,64,25,100,1113
2023-05,2320 - Department of Real Estate,28,108,130,27,19,22,334
2023-05,2600 - California Transportation Commission,22,2,10,2,1,0,37
2023-05,2660 - Department of Transportation,2307,2305,7070,1255,491,17,13445
2023-05,2665 - High-Speed Rail Authority,197,60,46,32,24,2,361
2023-05,2700 - California Traffic Safety Program,2,21,9,1,0,0,33
2023-05,2720 - California Highway Patrol,0,135,0,266,0,1034,1435
2023-05,2740 - Department of Motor Vehicles,500,117,423,259,57,393,1749
2023-05,3100 - Exposition Park,1,0,4,4,0,0,9
2023-05,3105 - California African-American Museum,0,0,0,0,16,0,16
2023-05,3125 - California Tahoe Conservancy,18,4,6,11,1,6,46
2023-05,3340 - California Conservation Corps,40,28,36,28,14,4,150
2023-05,3355 - Office of Energy Infrastructure Safety,79,0,0,0,0,0,79
2023-05,3360 - Energy Resources Conservation and Development Commission,624,50,29,8,7,0,718
2023-05,3480 - Department of Conservation,403,61,90,60,11,34,659
2023-05,3540 - Department of Forestry and Fire Protection,198,151,154,154,69,4,730
2023-05,3560 - State Lands Commission,90,25,14,13,6,28,176
2023-05,3600 - Department of Fish and Wildlife,63,926,306,282,104,367,2048
2023-05,3640 - Wildlife Conservation Board,18,5,4,2,0,14,43
2023-05,3720 - California Coastal Commission,48,73,43,10,6,2,182
2023-05,3760 - State Coastal Conservancy,43,19,2,2,0,0,66
2023-05,3780 - Native American Heritage Commission,0,1,4,2,1,0,8
2023-05,3790 - Department of Parks and Recreation,227,224,236,147,56,776,1666
2023-05,3810 - Santa Monica Mountains Conservancy,6,0,0,0,0,0,6
2023-05,3820 - San Francisco Bay Conservation and Development Commission,0,49,2,1,0,0,52
2023-05,3825 - San Gabriel and Lower Los Angeles Rivers and Mountains Conservancy,0,10,0,0,0,0,10
2023-05,3830 - San Joaquin River Conservancy,1,1,0,0,0,0,2
2023-05,3835 - Baldwin Hills Conservancy,0,1,2,1,0,0,4
2023-05,3840 - Delta Protection Commission,2,1,2,0,1,2,8
2023-05,3845 - San Diego River Conservancy,0,0,0,0,0,3,3
2023-05,3850 - Coachella Valley Mountains Conservancy,0,0,1,1,2,0,4
2023-05,3855 - Sierra Nevada Conservancy,18,10,14,5,2,0,49
2023-05,3860 - Department of Water Resources,145,392,1042,615,128,5,2327
2023-05,3862 - Central Valley Flood Protection Board,19,16,7,1,6,0,49
2023-05,3875 - Sacramento-San Joaquin Delta Conservancy,7,10,1,0,0,0,18
2023-05,3885 - Delta Stewardship Council,38,10,6,3,1,0,58
2023-05,3900 - State Air Resources Board,84,845,148,143,264,155,1639
2023-05,3930 - Department of Pesticide Regulation,194,103,91,26,7,1,422
2023-05,3940 - State Water Resources Control Board,1003,566,334,323,51,62,2339
2023-05,3960 - Department of Toxic Substances Control,663,139,65,120,25,9,1021
2023-05,3980 - Office of Environmental Health Hazard Assessment,108,20,5,1,0,0,134
2023-05,4100 - State Council on Developmental Disabilities,29,5,16,5,7,3,65
2023-05,4140 - Department of Health Care Access and Information,265,40,31,110,10,74,530
2023-05,4170 - Department of Aging,198,31,18,9,0,1,257
2023-05,4250 - California Children and Families Commission,1,0,32,0,0,0,33
2023-05,4260 - State Department of Health Care Services,2101,1116,312,133,35,478,4175
2023-05,4265 - Department of Public Health,2456,137,112,83,2,1126,3916
2023-05,4300 - Department of Developmental Services,435,99,50,37,12,5,638
2023-05,4440 - Department of State Hospitals,417,224,144,180,412,32,1409
2023-05,4560 - Mental Health Services Oversight and Accountability Commission,7,13,12,8,3,6,49
2023-05,4700 - Department of Community Services and Development,108,3,7,2,0,0,120
2023-05,4800 - California Health Benefit Exchange,1165,55,50,26,1,21,1318
2023-05,5160 - Department of Rehabilitation,244,229,493,412,139,133,1650
2023-05,5170 - State Independent Living Council,3,0,0,0,0,0,3
2023-05,5175 - Department of Child Support Services,458,97,10,11,12,0,588
2023-05,5180 - Department of Social Services,1751,602,364,1388,403,5,4513
2023-05,5225 - Department of Corrections and Rehabilitation,1657,402,555,702,436,908,4660
2023-05,5227 - Board of State and Community Corrections,8,87,7,1,2,11,116
2023-05,5420 - Prison Industry Authority,14,31,65,96,5,24,235
2023-05,6100 - Department of Education,929,97,91,23,15,198,1353
2023-05,6120 - California State Library,73,18,15,31,22,3,162
2023-05,6125 - Education Audit Appeals Panel,0,2,1,0,0,0,3
2023-05,6200 - California School for the Blind,0,0,2,1,3,16,22
2023-05,6240 - California School for the Deaf - Fremont,4,0,0,0,0,0,4
2023-05,6250 - California School for the Deaf - Riverside,0,2,2,5,3,5,17
2023-05,6260 - Diagnostic Centers,0,0,0,3,1,22,26
2023-05,6360 - Commission on Teacher Credentialing,23,88,27,24,10,21,193
2023-05,"6980 - Student Aid Commission, California",100,21,10,1,2,1,135
2023-05,7100 - Employment Development Department,5202,737,800,401,252,41,7433
2023-05,7120 - California Workforce Development Board,88,0,0,0,0,0,88
2023-05,7300 - Agricultural Labor Relations Board,5,5,35,4,0,8,57
2023-05,7320 - Public Employment Relations Board,9,24,19,5,3,2,62
2023-05,7501 - Department of Human Resources,147,55,77,18,10,3,310
2023-05,7502 - California Department of Technology,352,477,47,9,30,65,980
2023-05,7503 - State Personnel Board,53,12,2,1,0,1,69
2023-05,7504 - Office of Data and Innovation,38,4,2,0,0,0,44
2023-05,7600 - California Department of Tax and Fee Administration,1580,1456,468,82,27,25,3638
2023-05,7730 - Franchise Tax Board,164,208,3348,911,128,438,5197
2023-05,7760 - Department of General Services,885,230,256,315,29,357,2072
2023-05,7870 - California Victim Compensation Board,0,197,14,11,0,2,224
2023-05,7900 - Public Employees' Retirement System,270,4,10,1908,29,85,2306
2023-05,7910 - Office of Administrative Law,2,7,6,7,2,0,24
2023-05,7920 - State Teachers' Retirement System,4,35,1015,200,9,5,1268
2023-05,8120 - Commission on Peace Officer Standards and Training,13,0,0,150,2,10,175
2023-05,8140 - State Public Defender,49,6,15,12,1,6,89
2023-05,8560 - California Exposition and State Fair,0,0,0,0,0,0,0
2023-05,8570 - Department of Food and Agriculture,148,115,79,60,37,89,528
2023-05,8620 - Fair Political Practices Commission,61,17,12,2,0,1,93
2023-05,8660 - Public Utilities Commission,1099,86,56,67,3,1,1312
2023-05,"8780 - Milton Marks ""Little Hoover"" Commission on California State Government Organization and Economy",0,4,3,0,0,0,7
2023-05,"8830 - Law Revision Commission, California",8,0,0,0,0,0,8
2023-05,8860 - Department of Finance,38,28,276,30,6,7,385
2023-05,8880 - Financial Information System for California,290,18,7,1,0,0,316
2023-05,"8885 - States Mandates, Commission on",9,1,1,3,0,0,14
2023-05,8940 - Military Department,4,11,57,27,7,0,106
2023-05,8955 - Department of Veterans Affairs,125,97,124,60,19,38,463
2023-05,A059 - California Correctional Health Care Services,980,333,529,533,665,37,3077
2023-05,A279 - Unemployment Insurance Appeals Board,63,61,78,25,23,148,398
2023-05,A281 - Employment Training Panel,5,38,10,12,9,0,74
2023-05,A314 - California Science Center,3,0,0,21,3,7,34
2023-05,A341 - California Earthquake Authority,53,6,8,2,1,0,70
2023-05,A424 - Cradle-to-Career,8,0,5,0,0,0,13
2023-05,A541 - Board of Forestry and Fire Protection,2,4,3,0,1,0,10
2023-06,0500 - Governor's Office,13,12,42,33,9,28,137
2023-06,0509 - Governor's Office of Business and Economic Development (GO-Biz),106,15,17,11,3,2,154
2023-06,0511 - Secretary for Government Operations Agency,0,0,26,1,0,0,27
2023-06,0521 - Secretary for Transportation Agency,0,0,16,3,0,0,19
2023-06,0530 - Secretary for California Health and Human Services Agency,62,11,6,10,2,1,92
2023-06,0531 - Office of Systems Integration,355,17,9,1,2,6,390
2023-06,0540 - Secretary of the Natural Resources Agency,73,0,17,2,2,1,95
2023-06,0552 - Office of the Inspector General,118,7,7,2,4,5,143
2023-06,0555 - Secretary for Environmental Protection,40,6,3,2,2,34,87
2023-06,0559 - Secretary for Labor and Workforce Development Agency,4,3,7,11,6,5,36
2023-06,0650 - Office of Planning and Research,132,41,25,15,0,2,215
2023-06,0690 - Governor's Office of Emergency Services,328,83,131,300,80,0,922
2023-06,0820 - Department of Justice,1684,609,668,566,339,360,4226
2023-06,0840 - State Controller,736,159,140,82,38,44,1199
2023-06,0845 - Department of Insurance,543,203,60,34,175,4,1019
2023-06,0855 - California Gambling Control Commission,25,8,8,0,0,0,41
2023-06,0860 - State Board of Equalization,19,6,121,10,1,2,159
2023-06,0870 - Office of Tax Appeals,25,16,42,7,4,0,94
2023-06,0890 - Secretary of State,137,82,120,53,39,87,518
2023-06,0911 - Citizens Redistricting Commission,3,1,1,0,0,0,5
2023-06,1045 - Cannabis Control Appeals Panel,5,1,0,1,0,1,8
2023-06,1111 - Department of Consumer Affairs,531,573,411,491,318,222,2546
2023-06,1115 - Department of Cannabis Control,226,43,49,17,83,0,418
2023-06,1700 - California Civil Rights Department,207,38,19,3,1,4,272
2023-06,1701 - Department of Financial Protection and Innovation,576,64,20,64,8,0,732
2023-06,1703 - California Privacy Protection Agency,23,0,1,0,0,0,24
2023-06,1750 - California Horse Racing Board,11,2,7,0,5,1,26
2023-06,2100 - Department of Alcoholic Beverage Control,54,31,56,91,144,97,473
2023-06,2120 - Alcoholic Beverage Control Appeals Board,2,0,3,1,0,0,6
2023-06,2240 - Department of Housing and Community Development,736,101,84,66,25,97,1109
2023-06,2320 - Department of Real Estate,26,106,133,29,21,9,324
2023-06,2600 - California Transportation Commission,26,4,6,1,1,0,38
2023-06,2660 - Department of Transportation,2307,2304,7070,1255,491,17,13444
2023-06,2665 - High-Speed Rail Authority,191,58,49,36,25,2,361
2023-06,2700 - California Traffic Safety Program,2,21,9,1,0,0,33
2023-06,2720 - California Highway Patrol,0,66,15,316,0,1035,1432
2023-06,2740 - Department of Motor Vehicles,511,132,424,260,57,391,1775
2023-06,3100 - Exposition Park,1,0,4,4,0,0,9
2023-06,3125 - California Tahoe Conservancy,18,4,6,11,1,6,46
2023-06,3340 - California Conservation Corps,40,30,36,29,13,4,152
2023-06,3355 - Office of Energy Infrastructure Safety,76,0,0,0,0,0,76
2023-06,3360 - Energy Resources Conservation and Development Commission,628,50,30,9,7,0,724
2023-06,3480 - Department of Conservation,412,65,90,60,12,32,671
2023-06,3540 - Department of Forestry and Fire Protection,203,149,156,158,67,4,737
2023-06,3560 - State Lands Commission,91,26,15,13,6,28,179
2023-06,3600 - Department of Fish and Wildlife,57,899,311,285,104,406,2062
2023-06,3640 - Wildlife Conservation Board,18,5,7,2,0,11,43
2023-06,3720 - California Coastal Commission,48,74,43,10,7,2,184
2023-06,3760 - State Coastal Conservancy,43,19,2,2,0,0,66
2023-06,3780 - Native American Heritage Commission,0,1,4,2,1,0,8
2023-06,3790 - Department of Parks and Recreation,228,226,240,148,55,779,1676
2023-06,3810 - Santa Monica Mountains Conservancy,3,0,3,0,0,0,6
2023-06,3820 - San Francisco Bay Conservation and Development Commission,0,48,2,1,0,0,51
2023-06,3825 - San Gabriel and Lower Los Angeles Rivers and Mountains Conservancy,0,7,1,0,1,0,9
2023-06,3830 - San Joaquin River Conservancy,1,1,0,0,0,0,2
2023-06,3835 - Baldwin Hills Conservancy,0,1,2,1,0,0,4
2023-06,3840 - Delta Protection Commission,2,1,2,0,1,2,8
2023-06,3845 - San Diego River Conservancy,0,0,0,0,0,3,3
2023-06,3850 - Coachella Valley Mountains Conservancy,0,0,1,1,1,0,3
2023-06,3855 - Sierra Nevada Conservancy,18,10,15,5,2,0,50
2023-06,3860 - Department of Water Resources,138,389,1095,587,120,4,2333
2023-06,3862 - Central Valley Flood Protection Board,19,16,7,1,6,0,49
2023-06,3875 - Sacramento-San Joaquin Delta Conservancy,11,4,3,0,0,0,18
2023-06,3885 - Delta Stewardship Council,39,10,7,4,1,0,61
2023-06,3900 - State Air Resources Board,92,843,148,141,264,162,1650
2023-06,3930 - Department of Pesticide Regulation,195,102,90,27,8,1,423
2023-06,3940 - State Water Resources Control Board,996,566,341,334,56,55,2348
2023-06,3960 - Department of Toxic Substances Control,679,138,67,122,26,9,1041
2023-06,3980 - Office of Environmental Health Hazard Assessment,107,20,5,1,0,0,133
2023-06,4100 - State Council on Developmental Disabilities,29,5,16,5,7,3,65
2023-06,4140 - Department of Health Care Access and Information,277,41,30,111,9,74,542
2023-06,4150 - Department of Managed Health Care,543,5,6,0,0,0,554
2023-06,4170 - Department of Aging,200,33,18,8,0,1,260
2023-06,4250 - California Children and Families Commission,1,0,32,0,0,0,33
2023-06,4260 - State Department of Health Care Services,1983,1066,281,136,33,722,4221
2023-06,4265 - Department of Public Health,2456,137,112,83,2,1126,3916
2023-06,4300 - Department of Developmental Services,438,98,49,35,12,7,639
2023-06,4440 - Department of State Hospitals,437,253,144,187,616,0,1637
2023-06,4560 - Mental Health Services Oversight and Accountability Commission,6,12,14,9,3,5,49
2023-06,4700 - Department of Community Services and Development,101,10,8,2,0,0,121
2023-06,4800 - California Health Benefit Exchange,1164,55,50,26,1,20,1316
2023-06,5160 - Department of Rehabilitation,250,229,499,422,140,137,1677
2023-06,5170 - State Independent Living Council,3,0,0,0,0,0,3
2023-06,5175 - Department of Child Support Services,455,97,10,11,12,1,586
2023-06,5180 - Department of Social Services,1764,592,363,1373,400,5,4497
2023-06,5225 - Department of Corrections and Rehabilitation,1662,408,555,713,442,891,4671
2023-06,5227 - Board of State and Community Corrections,9,88,6,1,2,11,117
2023-06,5420 - Prison Industry Authority,18,26,47,117,7,17,232
2023-06,6100 - Department of Education,940,96,92,22,16,203,1369
2023-06,6120 - California State Library,75,19,15,31,21,3,164
2023-06,6125 - Education Audit Appeals Panel,0,2,1,0,0,0,3
2023-06,6200 - California School for the Blind,0,0,2,1,3,16,22
2023-06,6240 - California School for the Deaf - Fremont,4,0,0,0,0,0,4
2023-06,6250 - California School for the Deaf - Riverside,0,2,2,5,3,5,17
2023-06,6260 - Diagnostic Centers,0,0,0,3,1,22,26
2023-06,6360 - Commission on Teacher Credentialing,22,90,29,27,7,22,197
2023-06,"6980 - Student Aid Commission, California",100,21,10,1,2,1,135
2023-06,7100 - Employment Development Department,5227,743,804,415,251,43,7483
2023-06,7300 - Agricultural Labor Relations Board,5,5,35,4,0,8,57
2023-06,7320 - Public Employment Relations Board,9,24,19,5,3,2,62
2023-06,7501 - Department of Human Resources,152,60,80,19,10,6,327
2023-06,7502 - California Department of Technology,339,484,46,8,30,68,975
2023-06,7503 - State Personnel Board,52,11,4,0,0,2,69
2023-06,7504 - Office of Data and Innovation,38,4,4,0,0,0,46
2023-06,7600 - California Department of Tax and Fee Administration,1568,1468,475,79,31,21,3642
2023-06,7730 - Franchise Tax Board,160,206,3394,900,130,472,5262
2023-06,7760 - Department of General Services,897,230,246,328,27,357,2085
2023-06,7870 - California Victim Compensation Board,0,197,14,10,0,2,223
2023-06,7900 - Public Employees' Retirement System,274,4,10,1912,30,76,2306
2023-06,7910 - Office of Administrative Law,2,7,6,7,2,0,24
2023-06,7920 - State Teachers' Retirement System,3,35,1024,199,9,5,1275
2023-06,8120 - Commission on Peace Officer Standards and Training,13,0,0,157,2,7,179
2023-06,8140 - State Public Defender,49,6,15,15,1,7,93
2023-06,8560 - California Exposition and State Fair,0,0,0,0,0,0,0
2023-06,8570 - Department of Food and Agriculture,145,103,89,67,32,65,501
2023-06,8620 - Fair Political Practices Commission,60,17,12,2,0,1,92
2023-06,8660 - Public Utilities Commission,1100,95,45,72,6,101,1419
2023-06,"8780 - Milton Marks ""Little Hoover"" Commission on California State Government Organization and Economy",0,4,3,0,0,0,7
2023-06,"8830 - Law Revision Commission, California",8,0,0,0,0,0,8
2023-06,8860 - Department of Finance,39,29,273,30,6,7,384
2023-06,8880 - Financial Information System for California,289,18,12,3,0,1,323
2023-06,"8885 - States Mandates, Commission on",9,2,1,2,0,0,14
2023-06,8940 - Military Department,4,11,59,28,7,0,109
2023-06,8955 - Department of Veterans Affairs,124,91,130,58,20,36,459
2023-06,A059 - California Correctional Health Care Services,974,339,544,553,668,39,3117
2023-06,A279 - Unemployment Insurance Appeals Board,62,61,77,27,22,154,403
2023-06,A281 - Employment Training Panel,5,38,10,12,9,0,74
2023-06,A314 - California Science Center,3,0,0,22,4,6,35
2023-06,A341 - California Earthquake Authority,53,6,8,2,1,0,70
2023-06,A424 - Cradle-to-Career,8,0,6,0,0,0,14
2023-06,A541 - Board of Forestry and Fire Protection,2,4,3,0,1,0,10
2023-07,0500 - Governor's Office,12,12,42,33,9,29,137
2023-07,0509 - Governor's Office of Business and Economic Development (GO-Biz),105,15,17,11,3,1,152
2023-07,0511 - Secretary for Government Operations Agency,0,0,14,13,0,0,27
2023-07,0521 - Secretary for Transportation Agency,1,0,16,3,0,0,20
2023-07,0530 - Secretary for California Health and Human Services Agency,63,11,6,10,2,1,93
2023-07,0531 - Office of Systems Integration,360,17,9,1,2,5,394
2023-07,0540 - Secretary of the Natural Resources Agency,72,0,19,2,2,1,96
2023-07,0552 - Office of the Inspector General,127,7,8,4,4,6,156
2023-07,0555 - Secretary for Environmental Protection,42,6,3,2,2,34,89
2023-07,0559 - Secretary for Labor and Workforce Development Agency,4,3,7,11,6,5,36
2023-07,0650 - Office of Planning and Research,131,41,25,15,0,2,214
2023-07,0690 - Governor's Office of Emergency Services,209,52,75,532,86,0,954
2023-07,0820 - Department of Justice,1649,565,575,509,335,406,4039
2023-07,0840 - State Controller,734,159,143,83,37,47,1203
2023-07,0845 - Department of Insurance,585,200,63,30,170,5,1053
2023-07,0855 - California Gambling Control Commission,26,9,8,0,0,0,43
2023-07,0860 - State Board of Equalization,19,5,119,10,1,2,156
2023-07,0870 - Office of Tax Appeals,25,16,42,7,4,0,94
2023-07,0911 - Citizens Redistricting Commission,1,0,0,0,0,0,1
2023-07,1045 - Cannabis Control Appeals Panel,5,1,0,1,0,1,8
2023-07,1111 - Department of Consumer Affairs,531,573,411,491,318,222,2546
2023-07,1115 - Department of Cannabis Control,234,41,47,19,83,0,424
2023-07,1700 - California Civil Rights Department,202,36,18,3,1,4,264
2023-07,1701 - Department of Financial Protection and Innovation,604,61,23,45,11,6,750
2023-07,1703 - California Privacy Protection Agency,23,0,1,0,0,0,24
2023-07,1750 - California Horse Racing Board,11,2,6,0,5,1,25
2023-07,2100 - Department of Alcoholic Beverage Control,56,32,55,88,146,94,471
2023-07,2120 - Alcoholic Beverage Control Appeals Board,2,0,3,1,0,0,6
2023-07,2240 - Department of Housing and Community Development,730,104,86,66,24,106,1116
2023-07,2320 - Department of Real Estate,26,106,133,29,21,9,324
2023-07,2600 - California Transportation Commission,26,4,6,1,1,0,38
2023-07,2660 - Department of Transportation,2270,2262,7079,1242,445,39,13337
2023-07,2665 - High-Speed Rail Authority,190,56,48,35,26,3,358
2023-07,2700 - California Traffic Safety Program,2,21,10,1,0,0,34
2023-07,2720 - California Highway Patrol,0,64,15,333,0,1020,1432
2023-07,2740 - Department of Motor Vehicles,1035,412,532,468,146,1,2594
2023-07,3100 - Exposition Park,1,0,4,4,0,0,9
2023-07,3125 - California Tahoe Conservancy,18,4,6,11,1,6,46
2023-07,3340 - California Conservation Corps,30,25,49,31,14,4,153
2023-07,3355 - Office of Energy Infrastructure Safety,82,0,0,0,0,0,82
2023-07,3360 - Energy Resources Conservation and Development Commission,628,50,30,9,6,0,723
2023-07,3480 - Department of Conservation,412,69,94,60,12,33,680
2023-07,3540 - Department of Forestry and Fire Protection,206,152,172,174,69,4,777
2023-07,3560 - State Lands Commission,90,16,20,14,10,35,185
2023-07,3600 - Department of Fish and Wildlife,54,905,313,280,101,406,2059
2023-07,3640 - Wildlife Conservation Board,18,4,7,2,0,11,42
2023-07,3720 - California Coastal Commission,48,74,44,10,7,2,185
2023-07,3760 - State Coastal Conservancy,43,19,2,2,0,0,66
2023-07,3780 - Native American Heritage Commission,0,1,4,2,1,0,8
2023-07,3790 - Department of Parks and Recreation,219,217,205,142,50,729,1562
2023-07,3810 - Santa Monica Mountains Conservancy,3,0,3,0,0,0,6
2023-07,3820 - San Francisco Bay Conservation and Development Commission,0,50,3,1,0,0,54
2023-07,3825 - San Gabriel and Lower Los Angeles Rivers and Mountains Conservancy,0,7,1,1,0,0,9
2023-07,3830 - San Joaquin River Conservancy,1,1,0,0,0,0,2
2023-07,3835 - Baldwin Hills Conservancy,0,0,2,1,0,0,3
2023-07,3840 - Delta Protection Commission,2,1,1,0,1,1,6
2023-07,3845 - San Diego River Conservancy,0,0,0,0,0,3,3
2023-07,3850 - Coachella Valley Mountains Conservancy,0,0,1,1,1,0,3
2023-07,3855 - Sierra Nevada Conservancy,18,10,16,5,2,0,51
2023-07,3860 - Department of Water Resources,129,383,1087,572,114,3,2288
2023-07,3862 - Central Valley Flood Protection Board,18,16,7,1,6,0,48
2023-07,3875 - Sacramento-San Joaquin Delta Conservancy,8,9,1,0,0,0,18
2023-07,3885 - Delta Stewardship Council,41,10,7,4,1,0,63
2023-07,3900 - State Air Resources Board,106,851,150,138,264,172,1681
2023-07,3930 - Department of Pesticide Regulation,189,85,77,62,8,8,429
2023-07,3940 - State Water Resources Control Board,998,560,341,325,59,57,2340
2023-07,3960 - Department of Toxic Substances Control,684,134,67,123,25,8,1041
2023-07,3970 - Department of Resources Recycling and Recovery,370,98,40,25,17,3,553
2023-07,3980 - Office of Environmental Health Hazard Assessment,68,41,12,5,2,0,128
2023-07,4100 - State Council on Developmental Disabilities,29,5,16,5,7,3,65
2023-07,4140 - Department of Health Care Access and Information,285,42,31,109,8,74,549
2023-07,4150 - Department of Managed Health Care,546,5,6,0,0,0,557
2023-07,4170 - Department of Aging,208,25,19,8,0,1,261
2023-07,4250 - California Children and Families Commission,0,32,1,0,0,0,33
2023-07,4260 - State Department of Health Care Services,2067,1143,279,140,34,583,4246
2023-07,4265 - Department of Public Health,2454,137,112,83,2,1126,3914
2023-07,4300 - Department of Developmental Services,447,101,48,34,11,7,648
2023-07,4440 - Department of State Hospitals,474,235,149,185,676,0,1719
2023-07,4560 - Mental Health Services Oversight and Accountability Commission,8,11,13,7,3,5,47
2023-07,4700 - Department of Community Services and Development,99,11,8,2,0,0,120
2023-07,4800 - California Health Benefit Exchange,1152,55,50,28,1,21,1307
2023-07,5160 - Department of Rehabilitation,240,227,495,411,128,132,1633
2023-07,5170 - State Independent Living Council,3,0,0,0,0,0,3
2023-07,5175 - Department of Child Support Services,435,115,13,8,8,4,583
2023-07,5180 - Department of Social Services,1779,610,366,1374,401,5,4535
2023-07,5225 - Department of Corrections and Rehabilitation,1663,426,563,743,462,849,4706
2023-07,5227 - Board of State and Community Corrections,11,85,11,0,1,11,119
2023-07,5420 - Prison Industry Authority,20,25,46,113,8,21,233
2023-07,6100 - Department of Education,952,95,95,22,18,202,1384
2023-07,6120 - California State Library,73,19,15,31,22,3,163
2023-07,6125 - Education Audit Appeals Panel,0,2,1,0,0,0,3
2023-07,6200 - California School for the Blind,0,0,1,1,3,17,22
2023-07,6240 - California School for the Deaf - Fremont,4,0,0,0,0,0,4
2023-07,6250 - California School for the Deaf - Riverside,0,2,2,5,3,5,17
2023-07,6260 - Diagnostic Centers,0,0,0,3,1,22,26
2023-07,6360 - Commission on Teacher Credentialing,20,86,22,22,7,29,186
2023-07,6870 - Board of Governors of the California Community Colleges,187,3,4,1,0,0,195
2023-07,"6980 - Student Aid Commission, California",100,21,10,1,2,1,135
2023-07,7100 - Employment Development Department,5223,744,802,430,255,47,7501
2023-07,7300 - Agricultural Labor Relations Board,5,5,35,5,0,8,58
2023-07,7320 - Public Employment Relations Board,11,24,20,4,3,2,64
2023-07,7501 - Department of Human Resources,165,56,81,22,7,6,337
2023-07,7502 - California Department of Technology,329,490,45,8,32,66,970
2023-07,7503 - State Personnel Board,53,12,3,0,0,2,70
2023-07,7504 - Office of Data and Innovation,40,4,4,0,0,0,48
2023-07,7600 - California Department of Tax and Fee Administration,1548,1462,479,77,32,21,3619
2023-07,7730 - Franchise Tax Board,166,195,3415,907,126,454,5263
2023-07,7760 - Department of General Services,900,228,247,324,30,360,2089
2023-07,7870 - California Victim Compensation Board,0,199,13,11,0,2,225
2023-07,7900 - Public Employees' Retirement System,274,4,10,1921,26,77,2312
2023-07,7910 - Office of Administrative Law,2,7,6,7,2,0,24
2023-07,7920 - State Teachers' Retirement System,2,45,1110,119,4,1,1281
2023-07,8120 - Commission on Peace Officer Standards and Training,12,0,0,160,6,5,183
2023-07,8140 - State Public Defender,45,10,15,16,4,5,95
2023-07,8560 - California Exposition and State Fair,0,0,0,0,0,0,0
2023-07,8570 - Department of Food and Agriculture,150,122,82,61,35,93,543
2023-07,8620 - Fair Political Practices Commission,60,16,12,2,0,1,91
2023-07,8660 - Public Utilities Commission,1100,95,45,72,6,101,1419
2023-07,"8780 - Milton Marks ""Little Hoover"" Commission on California State Government Organization and Economy",0,4,2,0,0,0,6
2023-07,"8830 - Law Revision Commission, California",8,0,0,0,0,0,8
2023-07,8860 - Department of Finance,42,26,286,30,7,7,398
2023-07,8880 - Financial Information System for California,297,6,24,0,0,1,328
2023-07,"8885 - States Mandates, Commission on",9,2,1,1,1,0,14
2023-07,8940 - Military Department,4,11,59,28,8,0,110
2023-07,8955 - Department of Veterans Affairs,123,81,141,56,23,36,460
2023-07,A059 - California Correctional Health Care Services,974,344,532,537,658,37,3082
2023-07,A279 - Unemployment Insurance Appeals Board,61,59,77,27,23,160,407
2023-07,A281 - Employment Training Panel,5,38,10,12,9,0,74
2023-07,A314 - California Science Center,3,0,0,22,4,7,36
2023-07,A341 - California Earthquake Authority,53,6,8,2,1,0,70
2023-07,A424 - Cradle-to-Career,8,0,6,0,0,0,14
2023-07,A541 - Board of Forestry and Fire Protection,2,4,3,0,1,0,10
2023-08,0500 - Governor's Office,11,11,42,33,9,32,138
2023-08,0509 - Governor's Office of Business and Economic Development (GO-Biz),108,15,17,12,3,2,157
2023-08,0511 - Secretary for Government Operations Agency,0,0,14,13,0,0,27
2023-08,0521 - Secretary for Transportation Agency,1,0,16,3,0,0,20
2023-08,0530 - Secretary for California Health and Human Services Agency,63,11,6,10,2,1,93
2023-08,0531 - Office of Systems Integration,350,19,10,1,2,5,387
2023-08,0540 - Secretary of the Natural Resources Agency,71,0,19,2,2,1,95
2023-08,0552 - Office of the Inspector General,128,4,8,5,2,8,155
2023-08,0555 - Secretary for Environmental Protection,42,6,3,2,2,36,91
2023-08,0559 - Secretary for Labor and Workforce Development Agency,4,3,7,11,6,5,36
2023-08,0650 - Office of Planning and Research,129,41,25,15,0,2,212
2023-08,0690 - Governor's Office of Emergency Services,103,27,55,675,99,0,959
2023-08,0820 - Department of Justice,1634,564,561,475,280,504,4018
2023-08,0840 - State Controller,738,163,143,86,35,47,1212
2023-08,0845 - Department of Insurance,579,196,66,32,181,3,1057
2023-08,0855 - California Gambling Control Commission,26,9,8,0,0,0,43
2023-08,0860 - State Board of Equalization,20,5,120,10,1,2,158
2023-08,0870 - Office of Tax Appeals,25,16,41,7,4,0,93
2023-08,0911 - Citizens Redistricting Commission,1,0,0,0,0,0,1
2023-08,1045 - Cannabis Control Appeals Panel,5,1,0,1,0,1,8
2023-08,1111 - Department of Consumer Affairs,483,535,495,437,191,205,2346
2023-08,1115 - Department of Cannabis Control,227,42,52,17,90,0,428
2023-08,1700 - California Civil Rights Department,208,39,19,4,1,4,275
2023-08,1701 - Department of Financial Protection and Innovation,603,61,23,44,11,7,749
2023-08,1703 - California Privacy Protection Agency,23,0,1,0,0,0,24
2023-08,1750 - California Horse Racing Board,11,2,6,0,5,1,25
2023-08,2100 - Department of Alcoholic Beverage Control,55,31,55,88,144,95,468
2023-08,2120 - Alcoholic Beverage Control Appeals Board,2,0,3,1,0,0,6
2023-08,2240 - Department of Housing and Community Development,732,103,83,65,27,107,1117
2023-08,2320 - Department of Real Estate,28,108,130,25,22,10,323
2023-08,2600 - California Transportation Commission,26,4,6,1,1,0,38
2023-08,2660 - Department of Transportation,2270,2263,7080,1242,445,0,13300
2023-08,2665 - High-Speed Rail Authority,178,64,49,36,26,6,359
2023-08,2700 - California Traffic Safety Program,2,21,10,1,0,0,34
2023-08,2720 - California Highway Patrol,0,7,56,221,0,1197,1481
2023-08,2740 - Department of Motor Vehicles,1046,416,523,473,148,0,2606
2023-08,3100 - Exposition Park,1,0,4,4,0,0,9
2023-08,3125 - California Tahoe Conservancy,16,3,5,11,2,4,41
2023-08,3340 - California Conservation Corps,31,24,49,30,14,6,154
2023-08,3355 - Office of Energy Infrastructure Safety,83,0,0,0,0,0,83
2023-08,3360 - Energy Resources Conservation and Development Commission,643,53,33,10,6,0,745
2023-08,3480 - Department of Conservation,412,70,98,60,11,33,684
2023-08,3540 - Department of Forestry and Fire Protection,210,153,176,181,73,5,798
2023-08,3560 - State Lands Commission,91,17,20,14,9,35,186
2023-08,3600 - Department of Fish and Wildlife,45,910,321,286,100,395,2057
2023-08,3640 - Wildlife Conservation Board,17,4,8,2,0,11,42
2023-08,3720 - California Coastal Commission,48,74,45,13,7,2,189
2023-08,3760 - State Coastal Conservancy,0,62,3,2,0,0,67
2023-08,3780 - Native American Heritage Commission,0,1,4,2,1,0,8
2023-08,3790 - Department of Parks and Recreation,227,227,240,160,56,743,1653
2023-08,3810 - Santa Monica Mountains Conservancy,3,0,3,0,0,0,6
2023-08,3820 - San Francisco Bay Conservation and Development Commission,0,49,3,1,0,0,53
2023-08,3825 - San Gabriel and Lower Los Angeles Rivers and Mountains Conservancy,0,6,2,1,1,0,10
2023-08,3830 - San Joaquin River Conservancy,1,1,0,0,0,0,2
2023-08,3835 - Baldwin Hills Conservancy,0,0,2,1,0,0,3
2023-08,3840 - Delta Protection Commission,2,1,1,0,1,1,6
2023-08,3845 - San Diego River Conservancy,0,0,0,0,0,3,3
2023-08,3850 - Coachella Valley Mountains Conservancy,0,0,1,1,1,0,3
2023-08,3855 - Sierra Nevada Conservancy,19,9,16,5,2,0,51
2023-08,3860 - Department of Water Resources,140,395,1089,572,120,4,2320
2023-08,3862 - Central Valley Flood Protection Board,18,16,7,1,6,0,48
2023-08,3875 - Sacramento-San Joaquin Delta Conservancy,13,3,1,1,0,0,18
2023-08,3885 - Delta Stewardship Council,38,11,11,3,1,0,64
2023-08,3900 - State Air Resources Board,116,855,150,136,264,183,1704
2023-08,3930 - Department of Pesticide Regulation,188,85,79,63,10,8,433
2023-08,3940 - State Water Resources Control Board,1010,553,342,327,57,55,2344
2023-08,3980 - Office of Environmental Health Hazard Assessment,68,41,12,5,2,0,128
2023-08,4100 - State Council on Developmental Disabilities,29,5,16,5,7,3,65
2023-08,4140 - Department of Health Care Access and Information,287,42,30,108,9,77,553
2023-08,4150 - Department of Managed Health Care,537,5,3,0,0,0,545
2023-08,4170 - Department of Aging,208,25,20,9,0,1,263
2023-08,4250 - California Children and Families Commission,0,32,1,0,0,0,33
2023-08,4260 - State Department of Health Care Services,1842,998,211,130,25,1058,4264
2023-08,4265 - Department of Public Health,2454,137,112,83,2,1126,3914
2023-08,4300 - Department of Developmental Services,457,103,52,30,14,8,664
2023-08,4440 - Department of State Hospitals,487,243,151,186,768,2,1837
2023-08,4560 - Mental Health Services Oversight and Accountability Commission,6,12,14,8,3,6,49
2023-08,4700 - Department of Community Services and Development,99,11,8,2,0,0,120
2023-08,4800 - California Health Benefit Exchange,1182,56,49,29,1,21,1338
2023-08,5160 - Department of Rehabilitation,241,220,487,412,127,125,1612
2023-08,5170 - State Independent Living Council,3,0,0,0,0,0,3
2023-08,5175 - Department of Child Support Services,443,116,13,7,8,6,593
2023-08,5180 - Department of Social Services,1771,609,369,1361,400,5,4515
2023-08,5225 - Department of Corrections and Rehabilitation,1622,405,544,720,448,921,4660
2023-08,5227 - Board of State and Community Corrections,9,84,11,0,1,11,116
2023-08,5420 - Prison Industry Authority,17,22,46,115,8,17,225
2023-08,6100 - Department of Education,954,96,94,22,19,214,1399
2023-08,6120 - California State Library,72,18,14,31,21,2,158
2023-08,6125 - Education Audit Appeals Panel,0,2,1,0,0,0,3
2023-08,6200 - California School for the Blind,0,0,1,1,3,17,22
2023-08,6240 - California School for the Deaf - Fremont,4,0,0,0,0,0,4
2023-08,6250 - California School for the Deaf - Riverside,0,2,2,5,3,5,17
2023-08,6260 - Diagnostic Centers,0,0,0,3,1,22,26
2023-08,6360 - Commission on Teacher Credentialing,22,88,21,22,7,25,185
2023-08,"6980 - Student Aid Commission, California",100,21,10,1,2,1,135
2023-08,7100 - Employment Development Department,5122,740,795,431,251,46,7385
2023-08,7300 - Agricultural Labor Relations Board,5,5,36,5,0,8,59
2023-08,7320 - Public Employment Relations Board,11,24,20,4,3,1,63
2023-08,7501 - Department of Human Resources,157,57,84,20,7,8,333
2023-08,7502 - California Department of Technology,324,494,44,8,31,68,969
2023-08,7503 - State Personnel Board,51,10,6,0,0,2,69
2023-08,7504 - Office of Data and Innovation,43,4,4,0,0,0,51
2023-08,7600 - California Department of Tax and Fee Administration,1538,1463,486,75,29,32,3623
2023-08,7730 - Franchise Tax Board,174,130,3416,1099,117,478,5414
2023-08,7760 - Department of General Services,879,222,258,330,28,322,2039
2023-08,7870 - California Victim Compensation Board,0,202,13,11,0,2,228
2023-08,7900 - Public Employees' Retirement System,281,4,7,1997,27,78,2394
2023-08,7910 - Office of Administrative Law,2,7,6,7,2,0,24
2023-08,7920 - State Teachers' Retirement System,1,45,1117,121,5,3,1292
2023-08,8120 - Commission on Peace Officer Standards and Training,12,0,0,160,5,5,182
2023-08,8140 - State Public Defender,43,10,15,16,4,4,92
2023-08,8560 - California Exposition and State Fair,0,0,0,0,0,0,0
2023-08,8570 - Department of Food and Agriculture,180,126,93,63,37,107,606
2023-08,8620 - Fair Political Practices Commission,64,15,13,2,0,1,95
2023-08,8660 - Public Utilities Commission,1100,94,45,71,6,99,1415
2023-08,"8780 - Milton Marks ""Little Hoover"" Commission on California State Government Organization and Economy",0,4,2,0,0,0,6
2023-08,"8830 - Law Revision Commission, California",8,0,0,0,0,0,8
2023-08,8860 - Department of Finance,41,25,281,30,8,7,392
2023-08,8880 - Financial Information System for California,298,6,22,1,0,1,328
2023-08,"8885 - States Mandates, Commission on",9,3,1,1,1,0,15
2023-08,8940 - Military Department,5,11,59,26,9,0,110
2023-08,8955 - Department of Veterans Affairs,123,81,141,56,23,36,460
2023-08,A059 - California Correctional Health Care Services,991,357,556,540,696,1,3141
2023-08,A279 - Unemployment Insurance Appeals Board,60,59,75,28,23,161,406
2023-08,A281 - Employment Training Panel,5,38,10,12,9,0,74
2023-08,A314 - California Science Center,3,0,0,22,4,7,36
2023-08,A341 - California Earthquake Authority,53,6,8,2,1,0,70
2023-08,A424 - Cradle-to-Career,9,0,6,0,0,0,15
2023-08,A541 - Board of Forestry and Fire Protection,2,4,3,0,1,0,10
2023-09,0500 - Governor's Office,11,11,42,34,9,35,142
2023-09,0509 - Governor's Office of Business and Economic Development (GO-Biz),109,17,16,14,3,3,162
2023-09,0511 - Secretary for Government Operations Agency,0,0,14,13,0,0,27
2023-09,0521 - Secretary for Transportation Agency,1,0,16,3,0,0,20
2023-09,0530 - Secretary for California Health and Human Services Agency,67,11,6,10,2,1,97
2023-09,0531 - Office of Systems Integration,351,19,10,1,3,5,389
2023-09,0540 - Secretary of the Natural Resources Agency,73,1,20,3,1,1,99
2023-09,0552 - Office of the Inspector General,133,5,6,6,2,8,160
2023-09,0559 - Secretary for Labor and Workforce Development Agency,4,3,7,11,6,5,36
2023-09,0650 - Office of Planning and Research,126,38,25,15,0,2,206
2023-09,0690 - Governor's Office of Emergency Services,98,26,50,689,99,0,962
2023-09,0820 - Department of Justice,1616,575,502,583,313,406,3995
2023-09,0840 - State Controller,710,190,147,91,34,44,1216
2023-09,0845 - Department of Insurance,575,202,66,29,175,9,1056
2023-09,0855 - California Gambling Control Commission,21,11,8,0,1,2,43
2023-09,0860 - State Board of Equalization,20,6,120,10,1,2,159
2023-09,0870 - Office of Tax Appeals,27,16,42,8,4,0,97
2023-09,0911 - Citizens Redistricting Commission,1,0,0,0,0,0,1
2023-09,1045 - Cannabis Control Appeals Panel,5,1,0,1,0,1,8
2023-09,1111 - Department of Consumer Affairs,483,535,495,437,191,205,2346
2023-09,1115 - Department of Cannabis Control,229,40,48,20,89,0,426
2023-09,1700 - California Civil Rights Department,207,36,19,4,1,3,270
2023-09,1701 - Department of Financial Protection and Innovation,604,59,25,47,11,6,752
2023-09,1703 - California Privacy Protection Agency,24,0,1,0,0,0,25
2023-09,1750 - California Horse Racing Board,11,2,6,0,5,1,25
2023-09,2100 - Department of Alcoholic Beverage Control,58,31,55,87,143,95,469
2023-09,2240 - Department of Housing and Community Development,740,110,88,59,28,104,1129
2023-09,2320 - Department of Real Estate,28,107,131,21,22,10,319
2023-09,2600 - California Transportation Commission,27,4,6,0,1,0,38
2023-09,2660 - Department of Transportation,2270,2262,7079,1241,445,0,13297
2023-09,2665 - High-Speed Rail Authority,184,65,48,38,27,7,369
2023-09,2700 - California Traffic Safety Program,2,22,10,1,0,0,35
2023-09,2720 - California Highway Patrol,0,7,58,228,0,1170,1463
2023-09,2740 - Department of Motor Vehicles,1035,408,537,467,151,0,2598
2023-09,3100 - Exposition Park,1,0,4,4,0,0,9
2023-09,3125 - California Tahoe Conservancy,16,3,5,11,2,4,41
2023-09,3340 - California Conservation Corps,31,23,50,29,14,5,152
2023-09,3355 - Office of Energy Infrastructure Safety,82,0,0,0,0,0,82
2023-09,3360 - Energy Resources Conservation and Development Commission,654,55,34,10,7,0,760
2023-09,3480 - Department of Conservation,416,72,102,61,13,35,699
2023-09,3540 - Department of Forestry and Fire Protection,211,157,179,184,75,5,811
2023-09,3560 - State Lands Commission,80,27,27,10,15,30,189
2023-09,3600 - Department of Fish and Wildlife,32,941,316,277,83,417,2066
2023-09,3640 - Wildlife Conservation Board,16,6,7,2,0,12,43
2023-09,3720 - California Coastal Commission,48,74,45,13,7,2,189
2023-09,3760 - State Coastal Conservancy,0,62,3,2,0,0,67
2023-09,3780 - Native American Heritage Commission,0,1,4,2,1,0,8
2023-09,3790 - Department of Parks and Recreation,222,234,243,153,60,738,1650
2023-09,3810 - Santa Monica Mountains Conservancy,1,0,5,0,0,0,6
2023-09,3820 - San Francisco Bay Conservation and Development Commission,0,48,4,1,0,0,53
2023-09,3825 - San Gabriel and Lower Los Angeles Rivers and Mountains Conservancy,0,6,1,1,1,1,10
2023-09,3830 - San Joaquin River Conservancy,1,1,0,0,0,0,2
2023-09,3835 - Baldwin Hills Conservancy,0,0,2,1,0,0,3
2023-09,3840 - Delta Protection Commission,2,1,1,0,1,1,6
2023-09,3845 - San Diego River Conservancy,0,0,0,0,0,3,3
2023-09,3850 - Coachella Valley Mountains Conservancy,0,0,1,1,1,0,3
2023-09,3855 - Sierra Nevada Conservancy,19,9,16,5,2,0,51
2023-09,3860 - Department of Water Resources,95,405,1086,558,105,2,2251
2023-09,3862 - Central Valley Flood Protection Board,17,16,8,1,6,0,48
2023-09,3875 - Sacramento-San Joaquin Delta Conservancy,12,3,0,1,0,0,16
2023-09,3885 - Delta Stewardship Council,43,10,7,4,1,0,65
2023-09,3900 - State Air Resources Board,116,855,150,136,264,183,1704
2023-09,3930 - Department of Pesticide Regulation,190,83,81,64,10,7,435
2023-09,3940 - State Water Resources Control Board,1085,588,417,321,73,54,2538
2023-09,3960 - Department of Toxic Substances Control,701,135,66,126,31,8,1067
2023-09,3970 - Department of Resources Recycling and Recovery,414,99,34,30,10,0,587
2023-09,3980 - Office of Environmental Health Hazard Assessment,68,41,12,5,2,0,128
2023-09,4100 - State Council on Developmental Disabilities,29,5,16,5,7,3,65
2023-09,4140 - Department of Health Care Access and Information,287,40,29,110,10,77,553
2023-09,4150 - Department of Managed Health Care,531,5,3,0,0,0,539
2023-09,4170 - Department of Aging,212,23,22,8,0,1,266
2023-09,4250 - California Children and Families Commission,0,32,1,0,0,0,33
2023-09,4260 - State Department of Health Care Services,2123,1116,245,143,30,654,4311
2023-09,4265 - Department of Public Health,2454,137,112,83,2,1126,3914
2023-09,4300 - Department of Developmental Services,462,100,50,39,12,6,669
2023-09,4440 - Department of State Hospitals,489,243,154,183,749,1,1819
2023-09,4560 - Mental Health Services Oversight and Accountability Commission,6,12,14,8,3,6,49
2023-09,4700 - Department of Community Services and Development,100,11,8,2,0,0,121
2023-09,4800 - California Health Benefit Exchange,1183,55,49,29,1,21,1338
2023-09,5160 - Department of Rehabilitation,240,220,487,409,127,132,1615
2023-09,5170 - State Independent Living Council,3,0,0,0,0,0,3
2023-09,5175 - Department of Child Support Services,446,122,13,7,7,3,598
2023-09,5180 - Department of Social Services,1806,623,372,1384,395,3,4583
2023-09,5225 - Department of Corrections and Rehabilitation,1480,386,540,714,446,928,4494
2023-09,5227 - Board of State and Community Corrections,9,83,11,0,1,11,115
2023-09,5420 - Prison Industry Authority,20,20,48,113,9,17,227
2023-09,6100 - Department of Education,988,106,102,28,17,159,1400
2023-09,6120 - California State Library,72,18,14,31,21,3,159
2023-09,6125 - Education Audit Appeals Panel,0,2,1,0,0,0,3
2023-09,6200 - California School for the Blind,0,0,1,1,3,17,22
2023-09,6240 - California School for the Deaf - Fremont,4,0,0,0,0,0,4
2023-09,6250 - California School for the Deaf - Riverside,0,2,2,5,3,5,17
2023-09,6260 - Diagnostic Centers,0,0,0,3,1,22,26
2023-09,6360 - Commission on Teacher Credentialing,22,83,22,22,6,21,176
2023-09,6870 - Board of Governors of the California Community Colleges,193,2,4,0,0,0,199
2023-09,7100 - Employment Development Department,5138,746,796,437,255,46,7418
2023-09,7300 - Agricultural Labor Relations Board,5,5,37,5,0,8,60
2023-09,7320 - Public Employment Relations Board,11,24,20,4,3,1,63
2023-09,7501 - Department of Human Resources,154,59,83,20,8,9,333
2023-09,7502 - California Department of Technology,320,500,40,8,35,68,971
2023-09,7503 - State Personnel Board,48,16,4,0,0,1,69
2023-09,7504 - Office of Data and Innovation,43,5,4,0,0,0,52
2023-09,7600 - California Department of Tax and Fee Administration,1519,1463,487,75,27,32,3603
2023-09,7730 - Franchise Tax Board,188,101,3444,1216,112,516,5577
2023-09,7760 - Department of General Services,916,244,239,331,29,331,2090
2023-09,7870 - California Victim Compensation Board,0,202,15,17,0,1,235
2023-09,7900 - Public Employees' Retirement System,276,4,8,1994,30,79,2391
2023-09,7910 - Office of Administrative Law,2,6,4,10,2,0,24
2023-09,7920 - State Teachers' Retirement System,1,47,1114,117,3,4,1286
2023-09,8120 - Commission on Peace Officer Standards and Training,12,0,0,158,6,4,180
2023-09,8140 - State Public Defender,44,10,14,14,4,3,89
2023-09,8560 - California Exposition and State Fair,0,0,0,0,0,0,0
2023-09,8570 - Department of Food and Agriculture,146,114,77,61,29,82,509
2023-09,8620 - Fair Political Practices Commission,64,16,13,2,0,2,97
2023-09,8660 - Public Utilities Commission,1138,94,45,71,6,99,1453
2023-09,"8780 - Milton Marks ""Little Hoover"" Commission on California State Government Organization and Economy",0,4,2,0,0,0,6
2023-09,"8830 - Law Revision Commission, California",8,0,0,0,0,0,8
2023-09,8860 - Department of Finance,43,25,283,30,8,7,396
2023-09,8880 - Financial Information System for California,269,36,20,0,1,0,326
2023-09,"8885 - States Mandates, Commission on",9,3,1,1,1,0,15
2023-09,8940 - Military Department,4,12,55,23,10,1,105
2023-09,8955 - Department of Veterans Affairs,123,83,140,58,23,34,461
2023-09,A059 - California Correctional Health Care Services,1013,358,545,540,686,0,3142
2023-09,A279 - Unemployment Insurance Appeals Board,60,57,76,29,23,159,404
2023-09,A281 - Employment Training Panel,5,38,10,12,9,0,74
2023-09,A314 - California Science Center,3,0,0,20,5,5,33
2023-09,A341 - California Earthquake Authority,53,6,8,2,1,0,70
2023-09,A424 - Cradle-to-Career,9,1,7,0,0,0,17
2023-09,A541 - Board of Forestry and Fire Protection,2,4,3,0,1,0,10
2023-10,0500 - Governor's Office,13,11,44,34,9,33,144
2023-10,0509 - Governor's Office of Business and Economic Development (GO-Biz),105,15,17,14,3,1,155
2023-10,0511 - Secretary for Government Operations Agency,0,0,16,13,0,0,29
2023-10,"0515 - Secretary for Business, Consumer Services, and Housing Agency",47,6,10,3,2,1,69
2023-10,0521 - Secretary for Transportation Agency,1,0,16,3,0,0,20
2023-10,0530 - Secretary for California Health and Human Services Agency,72,11,6,10,2,1,102
2023-10,0531 - Office of Systems Integration,353,18,9,1,3,6,390
2023-10,0540 - Secretary of the Natural Resources Agency,74,1,20,3,1,1,100
2023-10,0552 - Office of the Inspector General,137,6,6,6,2,9,166
2023-10,0559 - Secretary for Labor and Workforce Development Agency,4,3,7,11,6,5,36
2023-10,0650 - Office of Planning and Research,124,38,24,15,0,2,203
2023-10,0690 - Governor's Office of Emergency Services,99,27,50,691,99,0,966
2023-10,0820 - Department of Justice,1679,580,587,539,295,425,4105
2023-10,0840 - State Controller,716,188,148,79,30,41,1202
2023-10,0845 - Department of Insurance,579,197,69,26,174,6,1051
2023-10,0855 - California Gambling Control Commission,21,11,8,0,1,2,43
2023-10,0860 - State Board of Equalization,21,6,121,10,1,2,161
2023-10,0870 - Office of Tax Appeals,27,16,42,7,4,0,96
2023-10,1045 - Cannabis Control Appeals Panel,5,1,0,1,0,1,8
2023-10,1111 - Department of Consumer Affairs,408,587,490,500,195,213,2393
2023-10,1115 - Department of Cannabis Control,231,40,53,20,92,0,436
2023-10,1700 - California Civil Rights Department,207,36,19,4,1,3,270
2023-10,1701 - Department of Financial Protection and Innovation,599,59,26,48,12,6,750
2023-10,1703 - California Privacy Protection Agency,26,0,1,0,0,0,27
2023-10,1750 - California Horse Racing Board,11,2,7,0,5,1,26
2023-10,2100 - Department of Alcoholic Beverage Control,60,31,55,89,142,91,468
2023-10,2120 - Alcoholic Beverage Control Appeals Board,2,0,3,1,0,0,6
2023-10,2240 - Department of Housing and Community Development,748,117,83,59,30,105,1142
2023-10,2320 - Department of Real Estate,27,107,132,21,22,10,319
2023-10,2600 - California Transportation Commission,27,4,6,0,1,0,38
2023-10,2660 - Department of Transportation,2270,2262,7074,1241,445,0,13292
2023-10,2665 - High-Speed Rail Authority,190,65,48,38,28,1,370
2023-10,2700 - California Traffic Safety Program,2,22,10,1,0,0,35
2023-10,2720 - California Highway Patrol,0,6,60,229,0,1168,1463
2023-10,2740 - Department of Motor Vehicles,1042,409,544,462,160,0,2617
2023-10,3100 - Exposition Park,1,0,3,4,0,0,8
2023-10,3125 - California Tahoe Conservancy,16,3,5,11,2,4,41
2023-10,3355 - Office of Energy Infrastructure Safety,62,0,0,0,0,0,62
2023-10,3360 - Energy Resources Conservation and Development Commission,667,55,33,10,7,0,772
2023-10,3480 - Department of Conservation,418,72,108,63,12,33,706
2023-10,3540 - Department of Forestry and Fire Protection,217,165,200,192,85,5,864
2023-10,3560 - State Lands Commission,81,28,28,11,14,33,195
2023-10,3600 - Department of Fish and Wildlife,28,941,322,285,85,392,2053
2023-10,3640 - Wildlife Conservation Board,16,6,8,2,0,11,43
2023-10,3720 - California Coastal Commission,19,25,130,12,8,1,195
2023-10,3760 - State Coastal Conservancy,0,0,66,1,0,0,67
2023-10,3780 - Native American Heritage Commission,0,1,4,2,1,0,8
2023-10,3790 - Department of Parks and Recreation,229,234,257,169,61,730,1680
2023-10,3810 - Santa Monica Mountains Conservancy,1,0,5,0,0,0,6
2023-10,3820 - San Francisco Bay Conservation and Development Commission,0,48,5,1,0,0,54
2023-10,3825 - San Gabriel and Lower Los Angeles Rivers and Mountains Conservancy,0,6,1,1,1,1,10
2023-10,3830 - San Joaquin River Conservancy,2,1,0,0,0,1,4
2023-10,3835 - Baldwin Hills Conservancy,0,0,2,1,0,0,3
2023-10,3840 - Delta Protection Commission,2,1,1,0,0,1,5
2023-10,3845 - San Diego River Conservancy,0,0,0,0,0,3,3
2023-10,3850 - Coachella Valley Mountains Conservancy,0,0,1,1,1,0,3
2023-10,3855 - Sierra Nevada Conservancy,19,9,16,5,2,0,51
2023-10,3860 - Department of Water Resources,95,430,1114,554,120,2,2315
2023-10,3862 - Central Valley Flood Protection Board,16,15,8,1,5,0,45
2023-10,3875 - Sacramento-San Joaquin Delta Conservancy,7,7,1,1,0,0,16
2023-10,3885 - Delta Stewardship Council,43,10,8,4,1,0,66
2023-10,3930 - Department of Pesticide Regulation,188,79,78,66,9,7,427
2023-10,3940 - State Water Resources Control Board,1157,617,447,339,83,77,2720
2023-10,3960 - Department of Toxic Substances Control,705,140,67,127,31,8,1078
2023-10,3970 - Department of Resources Recycling and Recovery,105,66,10,18,1,0,200
2023-10,3980 - Office of Environmental Health Hazard Assessment,68,41,12,5,2,0,128
2023-10,4140 - Department of Health Care Access and Information,291,42,28,110,10,75,556
2023-10,4150 - Department of Managed Health Care,568,5,3,0,0,0,576
2023-10,4170 - Department of Aging,214,20,23,9,0,1,267
2023-10,4250 - California Children and Families Commission,0,31,1,0,0,1,33
2023-10,4260 - State Department of Health Care Services,2172,1128,259,142,30,617,4348
2023-10,4265 - Department of Public Health,2454,137,112,83,2,1126,3914
2023-10,4300 - Department of Developmental Services,464,105,52,38,13,6,678
2023-10,4440 - Department of State Hospitals,493,244,153,189,805,1,1885
2023-10,4560 - Mental Health Services Oversight and Accountability Commission,6,13,14,8,2,6,49
2023-10,4700 - Department of Community Services and Development,102,11,8,2,0,0,123
2023-10,4800 - California Health Benefit Exchange,1179,58,49,29,1,22,1338
2023-10,5160 - Department of Rehabilitation,237,219,491,406,127,131,1611
2023-10,5170 - State Independent Living Council,3,0,0,0,0,0,3
2023-10,5175 - Department of Child Support Services,448,120,13,7,7,3,598
2023-10,5180 - Department of Social Services,1806,623,376,1356,394,3,4558
2023-10,5225 - Department of Corrections and Rehabilitation,1628,414,557,729,456,827,4611
2023-10,5227 - Board of State and Community Corrections,9,83,11,0,1,11,115
2023-10,5420 - Prison Industry Authority,19,21,48,119,8,11,226
2023-10,6120 - California State Library,71,18,14,33,24,3,163
2023-10,6125 - Education Audit Appeals Panel,0,2,1,0,0,0,3
2023-10,6200 - California School for the Blind,0,0,1,1,2,18,22
2023-10,6240 - California School for the Deaf - Fremont,4,0,0,0,1,0,5
2023-10,6250 - California School for the Deaf - Riverside,0,2,2,5,3,5,17
2023-10,6260 - Diagnostic Centers,0,0,0,3,1,22,26
2023-10,6360 - Commission on Teacher Credentialing,22,85,24,19,5,11,166
2023-10,6870 - Board of Governors of the California Community Colleges,194,2,4,0,0,0,200
2023-10,"6980 - Student Aid Commission, California",102,21,21,2,0,0,146
2023-10,7100 - Employment Development Department,5100,751,803,437,254,52,7397
2023-10,7300 - Agricultural Labor Relations Board,5,5,37,5,0,8,60
2023-10,7320 - Public Employment Relations Board,10,26,17,5,3,2,63
2023-10,7501 - Department of Human Resources,149,62,83,20,6,9,329
2023-10,7502 - California Department of Technology,313,507,41,7,35,69,972
2023-10,7503 - State Personnel Board,49,15,4,0,1,1,70
2023-10,7504 - Office of Data and Innovation,41,5,3,0,0,0,49
2023-10,7600 - California Department of Tax and Fee Administration,1514,1480,498,73,27,33,3625
2023-10,7730 - Franchise Tax Board,200,97,3448,1267,124,571,5707
2023-10,7760 - Department of General Services,918,259,231,332,27,340,2107
2023-10,7870 - California Victim Compensation Board,0,201,15,17,0,1,234
2023-10,7900 - Public Employees' Retirement System,287,5,6,2009,28,79,2414
2023-10,7910 - Office of Administrative Law,2,6,4,10,2,0,24
2023-10,7920 - State Teachers' Retirement System,1,46,1139,120,3,3,1312
2023-10,8120 - Commission on Peace Officer Standards and Training,12,0,0,163,5,3,183
2023-10,8140 - State Public Defender,45,9,14,14,4,3,89
2023-10,8560 - California Exposition and State Fair,0,0,0,0,0,0,0
2023-10,8570 - Department of Food and Agriculture,177,111,106,63,42,86,585
2023-10,8620 - Fair Political Practices Commission,64,16,13,2,0,2,97
2023-10,8660 - Public Utilities Commission,1111,91,47,81,6,24,1360
2023-10,"8780 - Milton Marks ""Little Hoover"" Commission on California State Government Organization and Economy",0,4,2,0,0,0,6
2023-10,"8830 - Law Revision Commission, California",9,0,0,0,0,0,9
2023-10,8860 - Department of Finance,43,25,291,31,8,7,405
2023-10,8880 - Financial Information System for California,268,36,20,0,1,0,325
2023-10,"8885 - States Mandates, Commission on",9,3,1,1,1,0,15
2023-10,8940 - Military Department,5,13,56,23,9,3,109
2023-10,8955 - Department of Veterans Affairs,127,80,139,58,22,35,461
2023-10,A059 - California Correctional Health Care Services,997,358,547,561,680,2,3145
2023-10,A279 - Unemployment Insurance Appeals Board,60,57,80,28,24,148,397
2023-10,A281 - Employment Training Panel,5,38,10,12,9,0,74
2023-10,A314 - California Science Center,3,0,0,20,5,5,33
2023-10,A341 - California Earthquake Authority,58,5,8,2,1,0,74
2023-10,A424 - Cradle-to-Career,9,2,6,2,0,0,19
2023-10,A541 - Board of Forestry and Fire Protection,2,4,3,0,1,0,10
