Report Month,Department,0 Days,1 Day,2 Days,3 Days,4 Days,5 Days,Total
2021-10,0500 - Governor's Office,12,3,19,13,17,39,103
2021-10,0509 - Governor's Office of Business and Economic Development (GO-Biz),1,5,5,5,17,92,125
2021-10,0511 - Secretary for Government Operations Agency,0,0,1,3,1,19,24
2021-10,"0515 - Secretary for Business, Consumer Services, and Housing Agency",1,0,1,3,10,32,47
2021-10,0521 - Secretary for Transportation Agency,1,0,2,0,19,0,22
2021-10,0531 - Office of Systems Integration,1,1,0,2,29,302,335
2021-10,0540 - Secretary of the Natural Resources Agency,0,0,8,1,1,76,86
2021-10,0552 - Office of the Inspector General,11,2,3,1,17,96,130
2021-10,0555 - Secretary for Environmental Protection,5,0,0,4,2,59,70
2021-10,0559 - Secretary for Labor and Workforce Development Agency,4,2,8,8,3,3,28
2021-10,0650 - Office of Planning and Research,0,2,10,9,5,86,112
2021-10,0690 - Governor's Office of Emergency Services,129,68,107,131,121,492,1048
2021-10,0820 - Department of Justice,359,321,528,511,538,1620,3877
2021-10,0855 - California Gambling Control Commission,0,0,2,3,9,23,37
2021-10,0860 - State Board of Equalization,0,0,6,0,0,148,154
2021-10,0890 - Secretary of State,8,22,40,392,0,101,563
2021-10,1045 - Cannabis Control Appeals Panel,0,1,1,0,1,5,8
2021-10,1111 - Department of Consumer Affairs,294,251,309,492,514,644,2504
2021-10,1115 - Department of Cannabis Control,68,1,12,36,20,242,379
2021-10,1700 - California Civil Rights Department,5,2,3,18,37,197,262
2021-10,1701 - Department of Financial Protection and Innovation,6,2,35,37,27,541,648
2021-10,1703 - California Privacy Protection Agency,1,0,0,0,0,1,2
2021-10,1750 - California Horse Racing Board,1,4,1,9,2,12,29
2021-10,2100 - Department of Alcoholic Beverage Control,24,98,154,98,33,45,452
2021-10,2120 - Alcoholic Beverage Control Appeals Board,0,0,1,2,1,2,6
2021-10,2240 - Department of Housing and Community Development,86,9,73,78,65,495,806
2021-10,2320 - Department of Real Estate,7,24,18,136,121,22,328
2021-10,2600 - California Transportation Commission,0,0,0,4,10,20,34
2021-10,2665 - High-Speed Rail Authority,8,17,26,41,37,162,291
2021-10,2720 - California Highway Patrol,1010,0,329,0,157,0,1496
2021-10,3105 - California African-American Museum,0,0,18,0,0,0,18
2021-10,3125 - California Tahoe Conservancy,1,0,0,0,0,41,42
2021-10,3340 - California Conservation Corps,0,0,49,9,91,0,149
2021-10,3355 - Office of Energy Infrastructure Safety,0,0,0,0,0,26,26
2021-10,3360 - Energy Resources Conservation and Development Commission,0,3,9,18,43,525,598
2021-10,3480 - Department of Conservation,35,21,58,89,88,325,616
2021-10,3540 - Department of Forestry and Fire Protection,4,7,20,30,37,61,159
2021-10,3560 - State Lands Commission,2,6,5,25,14,114,166
2021-10,3600 - Department of Fish and Wildlife,665,21,52,154,111,819,1822
2021-10,3640 - Wildlife Conservation Board,16,0,1,1,0,14,32
2021-10,3720 - California Coastal Commission,0,0,0,0,178,0,178
2021-10,3760 - State Coastal Conservancy,0,0,1,3,8,41,53
2021-10,3780 - Native American Heritage Commission,0,0,1,0,0,7,8
2021-10,3790 - Department of Parks and Recreation,321,118,173,103,98,349,1162
2021-10,3810 - Santa Monica Mountains Conservancy,0,0,0,0,0,7,7
2021-10,3820 - San Francisco Bay Conservation and Development Commission,0,0,0,0,0,48,48
2021-10,3825 - San Gabriel and Lower Los Angeles Rivers and Mountains Conservancy,0,0,0,5,3,0,8
2021-10,3830 - San Joaquin River Conservancy,0,0,0,0,1,2,3
2021-10,3835 - Baldwin Hills Conservancy,0,0,0,1,0,2,3
2021-10,3840 - Delta Protection Commission,0,1,0,0,2,2,5
2021-10,3845 - San Diego River Conservancy,3,0,0,0,0,0,3
2021-10,3850 - Coachella Valley Mountains Conservancy,0,2,1,1,0,0,4
2021-10,3855 - Sierra Nevada Conservancy,0,0,3,1,6,25,35
2021-10,3860 - Department of Water Resources,0,171,339,427,649,582,2168
2021-10,3862 - Central Valley Flood Protection Board,0,1,0,6,3,38,48
2021-10,3875 - Sacramento-San Joaquin Delta Conservancy,0,0,0,0,1,10,11
2021-10,3885 - Delta Stewardship Council,0,1,0,5,8,40,54
2021-10,3900 - State Air Resources Board,24,46,63,92,184,1223,1632
2021-10,3930 - Department of Pesticide Regulation,7,11,24,55,94,219,410
2021-10,3940 - State Water Resources Control Board,268,16,73,74,118,1673,2222
2021-10,3960 - Department of Toxic Substances Control,204,33,63,86,149,428,963
2021-10,3970 - Department of Resources Recycling and Recovery,63,21,28,84,104,464,764
2021-10,4100 - State Council on Developmental Disabilities,5,6,6,13,6,30,66
2021-10,4140 - Department of Health Care Access and Information,9,11,19,13,44,344,440
2021-10,4150 - Department of Managed Health Care,0,0,0,2,4,489,495
2021-10,4170 - Department of Aging,0,3,3,2,0,175,183
2021-10,4250 - California Children and Families Commission,0,0,0,13,0,0,13
2021-10,4265 - Department of Public Health,1126,24,83,112,137,2456,3938
2021-10,4300 - Department of Developmental Services,23,7,30,43,87,374,564
2021-10,4440 - Department of State Hospitals,51,121,183,77,272,269,973
2021-10,4700 - Department of Community Services and Development,1,0,1,0,3,103,108
2021-10,4800 - California Health Benefit Exchange,19,4,29,13,3,1257,1325
2021-10,5160 - Department of Rehabilitation,121,77,454,496,225,273,1646
2021-10,5175 - Department of Child Support Services,0,15,11,16,56,471,569
2021-10,5180 - Department of Social Services,0,388,1377,614,487,2285,5151
2021-10,5225 - Department of Corrections and Rehabilitation,1370,251,571,430,573,1342,4537
2021-10,5227 - Board of State and Community Corrections,0,2,1,1,2,94,100
2021-10,5420 - Prison Industry Authority,0,7,7,3,0,6,23
2021-10,6120 - California State Library,3,29,32,13,17,47,141
2021-10,6125 - Education Audit Appeals Panel,0,0,0,1,2,0,3
2021-10,6250 - California School for the Deaf - Riverside,6,0,10,1,2,0,19
2021-10,6360 - Commission on Teacher Credentialing,1,4,4,16,37,80,142
2021-10,6870 - Board of Governors of the California Community Colleges,0,0,1,4,1,162,168
2021-10,"6980 - Student Aid Commission, California",0,0,0,0,0,138,138
2021-10,7100 - Employment Development Department,27,26,207,281,168,985,1694
2021-10,7300 - Agricultural Labor Relations Board,4,1,4,34,7,13,63
2021-10,7320 - Public Employment Relations Board,1,3,4,14,26,21,69
2021-10,7501 - Department of Human Resources,8,4,13,21,36,213,295
2021-10,7502 - California Department of Technology,78,7,7,34,42,718,886
2021-10,7503 - State Personnel Board,0,0,0,8,18,51,77
2021-10,7504 - Office of Data and Innovation,0,0,0,0,0,17,17
2021-10,7600 - California Department of Tax and Fee Administration,21,12,114,329,521,2477,3474
2021-10,7730 - Franchise Tax Board,1514,44,91,95,581,2785,5110
2021-10,7760 - Department of General Services,371,74,88,94,192,1167,1986
2021-10,7870 - California Victim Compensation Board,3,0,0,0,0,220,223
2021-10,7910 - Office of Administrative Law,0,3,5,4,9,0,21
2021-10,7920 - State Teachers' Retirement System,0,0,0,2,2,1286,1290
2021-10,8120 - Commission on Peace Officer Standards and Training,3,1,3,128,0,0,135
2021-10,8140 - State Public Defender,8,2,13,7,4,46,80
2021-10,8560 - California Exposition and State Fair,0,0,1,0,1,0,2
2021-10,8570 - Department of Food and Agriculture,65,23,57,91,69,177,482
2021-10,8620 - Fair Political Practices Commission,1,0,0,0,2,77,80
2021-10,8660 - Public Utilities Commission,1,13,55,137,710,324,1240
2021-10,"8780 - Milton Marks ""Little Hoover"" Commission on California State Government Organization and Economy",0,0,0,0,0,7,7
2021-10,8825 - Commission on Asian and Pacific Islander American Affairs,0,0,0,0,0,1,1
2021-10,"8830 - Law Revision Commission, California",0,0,0,0,0,7,7
2021-10,8860 - Department of Finance,10,13,32,36,96,186,373
2021-10,8880 - Financial Information System for California,0,1,3,6,11,257,278
2021-10,"8885 - States Mandates, Commission on",0,0,1,0,9,1,11
2021-10,8940 - Military Department,0,5,15,3,5,10,38
2021-10,8955 - Department of Veterans Affairs,14,26,45,107,49,189,430
2021-10,A059 - California Correctional Health Care Services,157,163,451,456,251,705,2183
2021-10,A314 - California Science Center,2,2,26,0,0,2,32
2021-10,A341 - California Earthquake Authority,1,0,2,3,2,75,83
2021-10,A424 - Cradle-to-Career,0,0,0,0,0,1,1
2021-10,A541 - Board of Forestry and Fire Protection,0,0,0,0,1,0,1
2021-11,0500 - Governor's Office,13,6,17,15,19,36,106
2021-11,0509 - Governor's Office of Business and Economic Development (GO-Biz),1,3,5,7,20,91,127
2021-11,0511 - Secretary for Government Operations Agency,0,0,1,3,1,19,24
2021-11,"0515 - Secretary for Business, Consumer Services, and Housing Agency",1,0,1,3,10,31,46
2021-11,0521 - Secretary for Transportation Agency,1,0,2,0,19,0,22
2021-11,0531 - Office of Systems Integration,1,1,0,7,61,267,337
2021-11,0540 - Secretary of the Natural Resources Agency,0,0,8,1,0,78,87
2021-11,0552 - Office of the Inspector General,12,2,2,0,11,103,130
2021-11,0555 - Secretary for Environmental Protection,4,0,0,4,2,57,67
2021-11,0559 - Secretary for Labor and Workforce Development Agency,4,2,8,8,3,3,28
2021-11,0650 - Office of Planning and Research,0,2,10,9,5,86,112
2021-11,0690 - Governor's Office of Emergency Services,121,61,119,140,110,502,1053
2021-11,0820 - Department of Justice,359,321,528,511,538,1620,3877
2021-11,0855 - California Gambling Control Commission,0,0,2,3,9,23,37
2021-11,0860 - State Board of Equalization,0,0,7,0,0,151,158
2021-11,0890 - Secretary of State,8,22,40,392,0,101,563
2021-11,1045 - Cannabis Control Appeals Panel,0,1,1,0,1,5,8
2021-11,1111 - Department of Consumer Affairs,312,257,310,502,498,645,2524
2021-11,1115 - Department of Cannabis Control,67,1,12,37,20,251,388
2021-11,1700 - California Civil Rights Department,5,2,3,18,37,197,262
2021-11,1701 - Department of Financial Protection and Innovation,10,2,33,38,27,548,658
2021-11,1703 - California Privacy Protection Agency,1,0,0,0,0,1,2
2021-11,1750 - California Horse Racing Board,1,4,1,9,2,12,29
2021-11,2100 - Department of Alcoholic Beverage Control,22,101,153,94,33,45,448
2021-11,2120 - Alcoholic Beverage Control Appeals Board,0,0,1,2,1,2,6
2021-11,2240 - Department of Housing and Community Development,87,9,74,80,67,506,823
2021-11,2320 - Department of Real Estate,7,24,18,136,121,22,328
2021-11,2600 - California Transportation Commission,0,0,0,4,10,20,34
2021-11,2665 - High-Speed Rail Authority,10,13,22,48,29,172,294
2021-11,2720 - California Highway Patrol,1010,0,336,0,157,0,1503
2021-11,3105 - California African-American Museum,0,0,18,0,0,0,18
2021-11,3125 - California Tahoe Conservancy,1,0,0,0,0,41,42
2021-11,3340 - California Conservation Corps,0,0,49,9,90,0,148
2021-11,3355 - Office of Energy Infrastructure Safety,0,0,0,0,0,30,30
2021-11,3360 - Energy Resources Conservation and Development Commission,0,3,9,18,43,525,598
2021-11,3480 - Department of Conservation,35,21,58,89,88,327,618
2021-11,3540 - Department of Forestry and Fire Protection,4,11,20,36,43,67,181
2021-11,3560 - State Lands Commission,2,6,5,27,14,113,167
2021-11,3600 - Department of Fish and Wildlife,665,21,52,154,111,819,1822
2021-11,3640 - Wildlife Conservation Board,16,0,1,1,0,14,32
2021-11,3720 - California Coastal Commission,0,0,0,0,178,0,178
2021-11,3760 - State Coastal Conservancy,0,0,2,3,8,41,54
2021-11,3780 - Native American Heritage Commission,0,0,1,0,0,7,8
2021-11,3790 - Department of Parks and Recreation,323,114,173,104,99,349,1162
2021-11,3810 - Santa Monica Mountains Conservancy,0,0,0,0,0,7,7
2021-11,3820 - San Francisco Bay Conservation and Development Commission,0,0,0,0,0,48,48
2021-11,3825 - San Gabriel and Lower Los Angeles Rivers and Mountains Conservancy,0,0,0,3,6,0,9
2021-11,3830 - San Joaquin River Conservancy,0,0,0,0,1,2,3
2021-11,3835 - Baldwin Hills Conservancy,0,0,0,0,1,2,3
2021-11,3840 - Delta Protection Commission,0,1,0,0,2,2,5
2021-11,3845 - San Diego River Conservancy,3,0,0,0,0,0,3
2021-11,3850 - Coachella Valley Mountains Conservancy,0,2,1,1,0,0,4
2021-11,3855 - Sierra Nevada Conservancy,0,0,3,2,6,28,39
2021-11,3860 - Department of Water Resources,0,254,392,494,774,272,2186
2021-11,3862 - Central Valley Flood Protection Board,0,1,0,12,3,38,54
2021-11,3875 - Sacramento-San Joaquin Delta Conservancy,0,0,0,0,1,10,11
2021-11,3885 - Delta Stewardship Council,0,1,0,5,8,41,55
2021-11,3900 - State Air Resources Board,27,48,63,107,175,1212,1632
2021-11,3930 - Department of Pesticide Regulation,6,11,21,64,90,219,411
2021-11,3940 - State Water Resources Control Board,278,16,76,76,119,1698,2263
2021-11,3960 - Department of Toxic Substances Control,239,54,62,165,387,59,966
2021-11,3970 - Department of Resources Recycling and Recovery,53,22,32,79,108,470,764
2021-11,4100 - State Council on Developmental Disabilities,5,6,6,13,6,30,66
2021-11,4140 - Department of Health Care Access and Information,10,11,26,14,49,331,441
2021-11,4150 - Department of Managed Health Care,0,0,0,2,4,488,494
2021-11,4170 - Department of Aging,0,3,3,2,0,174,182
2021-11,4250 - California Children and Families Commission,0,0,0,13,0,0,13
2021-11,4265 - Department of Public Health,1126,24,83,112,137,2456,3938
2021-11,4300 - Department of Developmental Services,26,6,34,39,87,372,564
2021-11,4440 - Department of State Hospitals,45,129,187,73,274,276,984
2021-11,4700 - Department of Community Services and Development,1,0,1,0,3,104,109
2021-11,4800 - California Health Benefit Exchange,17,4,28,15,3,1264,1331
2021-11,5160 - Department of Rehabilitation,128,93,443,491,228,269,1652
2021-11,5175 - Department of Child Support Services,0,15,11,17,56,469,568
2021-11,5180 - Department of Social Services,0,388,1377,614,487,2285,5151
2021-11,5225 - Department of Corrections and Rehabilitation,1370,251,571,430,573,1342,4537
2021-11,5227 - Board of State and Community Corrections,0,3,1,0,1,95,100
2021-11,5420 - Prison Industry Authority,0,8,29,47,34,15,133
2021-11,6120 - California State Library,3,29,32,11,19,49,143
2021-11,6125 - Education Audit Appeals Panel,0,0,0,1,2,0,3
2021-11,6250 - California School for the Deaf - Riverside,6,0,10,1,2,0,19
2021-11,6360 - Commission on Teacher Credentialing,2,4,5,17,36,81,145
2021-11,6870 - Board of Governors of the California Community Colleges,0,0,1,4,1,164,170
2021-11,"6980 - Student Aid Commission, California",0,0,0,0,0,138,138
2021-11,7100 - Employment Development Department,26,26,207,285,168,988,1700
2021-11,7300 - Agricultural Labor Relations Board,3,1,4,33,7,14,62
2021-11,7320 - Public Employment Relations Board,1,4,5,15,26,21,72
2021-11,7501 - Department of Human Resources,9,3,12,21,35,217,297
2021-11,7502 - California Department of Technology,101,3,9,24,44,704,885
2021-11,7503 - State Personnel Board,0,1,2,3,17,54,77
2021-11,7504 - Office of Data and Innovation,0,0,0,0,0,17,17
2021-11,7600 - California Department of Tax and Fee Administration,21,12,114,329,521,2477,3474
2021-11,7730 - Franchise Tax Board,1514,44,91,95,580,2784,5108
2021-11,7760 - Department of General Services,372,72,81,96,187,1154,1962
2021-11,7870 - California Victim Compensation Board,3,0,0,0,0,222,225
2021-11,7910 - Office of Administrative Law,0,3,5,4,9,0,21
2021-11,7920 - State Teachers' Retirement System,0,0,0,2,1,1283,1286
2021-11,8120 - Commission on Peace Officer Standards and Training,3,3,3,123,1,0,133
2021-11,8140 - State Public Defender,8,2,13,7,5,48,83
2021-11,8560 - California Exposition and State Fair,0,0,1,0,1,0,2
2021-11,8570 - Department of Food and Agriculture,64,22,60,70,70,171,457
2021-11,8620 - Fair Political Practices Commission,1,0,0,0,2,78,81
2021-11,8660 - Public Utilities Commission,0,13,55,139,702,327,1236
2021-11,"8780 - Milton Marks ""Little Hoover"" Commission on California State Government Organization and Economy",0,0,0,0,0,7,7
2021-11,8825 - Commission on Asian and Pacific Islander American Affairs,0,0,0,0,0,1,1
2021-11,"8830 - Law Revision Commission, California",0,0,0,0,0,7,7
2021-11,8860 - Department of Finance,10,13,32,36,96,191,378
2021-11,8880 - Financial Information System for California,0,0,3,6,10,266,285
2021-11,"8885 - States Mandates, Commission on",0,0,1,0,9,1,11
2021-11,8940 - Military Department,0,5,15,3,5,10,38
2021-11,8955 - Department of Veterans Affairs,14,26,45,107,49,189,430
2021-11,A059 - California Correctional Health Care Services,159,169,457,466,261,726,2238
2021-11,A314 - California Science Center,2,2,26,0,0,2,32
2021-11,A341 - California Earthquake Authority,1,0,2,4,2,75,84
2021-11,A424 - Cradle-to-Career,0,0,0,1,0,2,3
2021-11,A541 - Board of Forestry and Fire Protection,0,0,0,0,1,0,1
2021-12,0500 - Governor's Office,11,7,15,16,23,38,110
2021-12,0509 - Governor's Office of Business and Economic Development (GO-Biz),1,2,5,7,16,95,126
2021-12,0511 - Secretary for Government Operations Agency,0,0,0,5,1,23,29
2021-12,"0515 - Secretary for Business, Consumer Services, and Housing Agency",1,0,2,3,11,35,52
2021-12,0521 - Secretary for Transportation Agency,1,0,2,0,19,0,22
2021-12,0531 - Office of Systems Integration,0,2,0,5,33,297,337
2021-12,0540 - Secretary of the Natural Resources Agency,0,0,8,1,0,78,87
2021-12,0552 - Office of the Inspector General,11,3,4,0,7,108,133
2021-12,0555 - Secretary for Environmental Protection,4,0,0,4,2,58,68
2021-12,0559 - Secretary for Labor and Workforce Development Agency,4,2,8,8,3,3,28
2021-12,0650 - Office of Planning and Research,0,2,10,9,5,86,112
2021-12,0690 - Governor's Office of Emergency Services,114,76,113,132,106,520,1061
2021-12,0820 - Department of Justice,359,321,528,511,538,1620,3877
2021-12,0855 - California Gambling Control Commission,0,0,1,4,9,23,37
2021-12,0860 - State Board of Equalization,0,0,7,0,0,152,159
2021-12,0890 - Secretary of State,8,22,40,392,0,101,563
2021-12,1045 - Cannabis Control Appeals Panel,0,1,1,0,1,5,8
2021-12,1111 - Department of Consumer Affairs,297,269,315,509,501,633,2524
2021-12,1115 - Department of Cannabis Control,69,1,13,39,20,249,391
2021-12,1700 - California Civil Rights Department,5,2,3,18,37,197,262
2021-12,1701 - Department of Financial Protection and Innovation,10,2,34,37,26,558,667
2021-12,1703 - California Privacy Protection Agency,1,0,0,0,0,2,3
2021-12,1750 - California Horse Racing Board,1,4,1,9,2,12,29
2021-12,2100 - Department of Alcoholic Beverage Control,25,95,158,93,34,45,450
2021-12,2120 - Alcoholic Beverage Control Appeals Board,0,0,1,2,1,2,6
2021-12,2240 - Department of Housing and Community Development,87,9,74,80,67,513,830
2021-12,2320 - Department of Real Estate,7,24,18,136,121,22,328
2021-12,2600 - California Transportation Commission,0,0,0,4,10,22,36
2021-12,2665 - High-Speed Rail Authority,10,12,28,47,29,172,298
2021-12,2720 - California Highway Patrol,1009,0,332,0,154,0,1495
2021-12,3105 - California African-American Museum,0,0,18,0,0,0,18
2021-12,3125 - California Tahoe Conservancy,1,0,0,0,0,41,42
2021-12,3340 - California Conservation Corps,0,0,50,9,91,0,150
2021-12,3355 - Office of Energy Infrastructure Safety,0,0,0,0,0,30,30
2021-12,3360 - Energy Resources Conservation and Development Commission,0,3,9,18,43,525,598
2021-12,3480 - Department of Conservation,34,21,58,89,88,329,619
2021-12,3540 - Department of Forestry and Fire Protection,4,12,26,38,45,67,192
2021-12,3560 - State Lands Commission,2,6,5,29,14,113,169
2021-12,3600 - Department of Fish and Wildlife,665,21,52,154,111,819,1822
2021-12,3640 - Wildlife Conservation Board,16,0,1,1,0,14,32
2021-12,3720 - California Coastal Commission,0,0,0,0,178,0,178
2021-12,3760 - State Coastal Conservancy,0,0,2,3,8,41,54
2021-12,3780 - Native American Heritage Commission,0,0,1,0,0,7,8
2021-12,3790 - Department of Parks and Recreation,272,124,195,117,109,354,1171
2021-12,3810 - Santa Monica Mountains Conservancy,0,0,0,0,0,7,7
2021-12,3820 - San Francisco Bay Conservation and Development Commission,0,0,0,0,0,48,48
2021-12,3825 - San Gabriel and Lower Los Angeles Rivers and Mountains Conservancy,0,0,0,2,6,1,9
2021-12,3830 - San Joaquin River Conservancy,0,0,0,0,1,2,3
2021-12,3835 - Baldwin Hills Conservancy,0,0,0,0,1,2,3
2021-12,3840 - Delta Protection Commission,0,1,0,0,2,2,5
2021-12,3845 - San Diego River Conservancy,3,0,0,0,0,0,3
2021-12,3850 - Coachella Valley Mountains Conservancy,0,2,1,1,0,0,4
2021-12,3855 - Sierra Nevada Conservancy,0,0,3,1,7,29,40
2021-12,3860 - Department of Water Resources,23,229,298,473,663,542,2228
2021-12,3862 - Central Valley Flood Protection Board,0,1,0,12,3,38,54
2021-12,3875 - Sacramento-San Joaquin Delta Conservancy,0,0,0,0,1,10,11
2021-12,3885 - Delta Stewardship Council,0,1,0,5,8,41,55
2021-12,3900 - State Air Resources Board,13,73,93,369,543,463,1554
2021-12,3930 - Department of Pesticide Regulation,7,14,19,66,101,214,421
2021-12,3940 - State Water Resources Control Board,296,16,81,79,121,1722,2315
2021-12,3960 - Department of Toxic Substances Control,290,23,78,130,146,313,980
2021-12,3970 - Department of Resources Recycling and Recovery,44,23,22,68,117,490,764
2021-12,4100 - State Council on Developmental Disabilities,5,6,6,13,6,30,66
2021-12,4140 - Department of Health Care Access and Information,10,11,26,14,47,334,442
2021-12,4150 - Department of Managed Health Care,0,0,0,2,4,483,489
2021-12,4170 - Department of Aging,1,3,6,4,3,173,190
2021-12,4250 - California Children and Families Commission,0,0,0,13,0,0,13
2021-12,4265 - Department of Public Health,1126,24,83,112,137,2456,3938
2021-12,4300 - Department of Developmental Services,27,5,31,41,86,369,559
2021-12,4440 - Department of State Hospitals,43,133,186,73,263,282,980
2021-12,4700 - Department of Community Services and Development,1,0,1,0,3,103,108
2021-12,4800 - California Health Benefit Exchange,18,3,24,11,3,1264,1323
2021-12,5160 - Department of Rehabilitation,124,92,436,491,221,270,1634
2021-12,5175 - Department of Child Support Services,0,15,11,17,58,473,574
2021-12,5180 - Department of Social Services,0,388,1377,614,487,2285,5151
2021-12,5225 - Department of Corrections and Rehabilitation,1369,251,571,429,573,1341,4534
2021-12,5227 - Board of State and Community Corrections,0,3,0,0,1,95,99
2021-12,5420 - Prison Industry Authority,1,8,38,88,34,17,186
2021-12,6120 - California State Library,3,29,32,12,18,51,145
2021-12,6125 - Education Audit Appeals Panel,0,0,0,1,2,0,3
2021-12,6250 - California School for the Deaf - Riverside,6,0,10,1,2,0,19
2021-12,6360 - Commission on Teacher Credentialing,2,4,5,16,36,82,145
2021-12,6870 - Board of Governors of the California Community Colleges,0,0,1,4,1,163,169
2021-12,"6980 - Student Aid Commission, California",0,0,0,0,0,138,138
2021-12,7100 - Employment Development Department,26,26,209,273,168,983,1685
2021-12,7300 - Agricultural Labor Relations Board,3,1,4,33,7,14,62
2021-12,7320 - Public Employment Relations Board,1,4,4,17,26,21,73
2021-12,7501 - Department of Human Resources,7,6,10,22,37,214,296
2021-12,7502 - California Department of Technology,78,7,7,34,42,718,886
2021-12,7503 - State Personnel Board,0,0,2,4,17,53,76
2021-12,7504 - Office of Data and Innovation,0,0,0,0,0,19,19
2021-12,7600 - California Department of Tax and Fee Administration,21,12,114,329,521,2477,3474
2021-12,7730 - Franchise Tax Board,1609,44,78,84,552,2733,5100
2021-12,7760 - Department of General Services,387,72,83,95,185,1139,1961
2021-12,7870 - California Victim Compensation Board,2,0,0,0,0,223,225
2021-12,7910 - Office of Administrative Law,0,3,5,4,9,0,21
2021-12,7920 - State Teachers' Retirement System,0,0,0,2,2,1291,1295
2021-12,8120 - Commission on Peace Officer Standards and Training,2,2,3,126,1,0,134
2021-12,8140 - State Public Defender,9,2,13,7,5,47,83
2021-12,8560 - California Exposition and State Fair,0,0,1,0,1,0,2
2021-12,8570 - Department of Food and Agriculture,58,19,61,70,72,187,467
2021-12,8620 - Fair Political Practices Commission,1,0,0,0,2,79,82
2021-12,8660 - Public Utilities Commission,0,13,55,139,701,330,1238
2021-12,"8780 - Milton Marks ""Little Hoover"" Commission on California State Government Organization and Economy",0,0,0,0,0,7,7
2021-12,"8830 - Law Revision Commission, California",0,0,0,0,0,7,7
2021-12,8860 - Department of Finance,10,13,32,36,96,191,378
2021-12,8880 - Financial Information System for California,0,2,1,6,7,268,284
2021-12,"8885 - States Mandates, Commission on",0,0,1,0,9,1,11
2021-12,8940 - Military Department,0,5,15,3,5,10,38
2021-12,8955 - Department of Veterans Affairs,14,26,45,106,49,189,429
2021-12,A059 - California Correctional Health Care Services,155,168,453,465,258,722,2221
2021-12,A314 - California Science Center,2,2,26,0,0,2,32
2021-12,A341 - California Earthquake Authority,1,0,2,3,2,74,82
2021-12,A424 - Cradle-to-Career,0,0,0,1,0,4,5
2021-12,A541 - Board of Forestry and Fire Protection,0,0,0,0,1,0,1
2022-01,0500 - Governor's Office,13,5,19,11,14,53,115
2022-01,0509 - Governor's Office of Business and Economic Development (GO-Biz),1,5,5,5,16,96,128
2022-01,0511 - Secretary for Government Operations Agency,0,0,0,4,1,24,29
2022-01,"0515 - Secretary for Business, Consumer Services, and Housing Agency",1,0,2,3,11,35,52
2022-01,0521 - Secretary for Transportation Agency,1,0,2,0,19,0,22
2022-01,0531 - Office of Systems Integration,0,1,1,6,48,281,337
2022-01,0540 - Secretary of the Natural Resources Agency,0,0,8,1,0,76,85
2022-01,0552 - Office of the Inspector General,13,0,1,3,7,108,132
2022-01,0555 - Secretary for Environmental Protection,5,0,0,4,2,57,68
2022-01,0559 - Secretary for Labor and Workforce Development Agency,4,2,8,8,3,3,28
2022-01,0650 - Office of Planning and Research,0,2,11,10,8,90,121
2022-01,0690 - Governor's Office of Emergency Services,120,55,101,148,115,515,1054
2022-01,0820 - Department of Justice,359,321,528,511,538,1620,3877
2022-01,0855 - California Gambling Control Commission,0,0,2,3,15,18,38
2022-01,0860 - State Board of Equalization,0,0,8,0,0,152,160
2022-01,0890 - Secretary of State,8,22,40,392,0,101,563
2022-01,1045 - Cannabis Control Appeals Panel,0,1,1,0,1,5,8
2022-01,1111 - Department of Consumer Affairs,284,291,338,484,441,657,2495
2022-01,1115 - Department of Cannabis Control,70,1,13,36,20,255,395
2022-01,1700 - California Civil Rights Department,5,2,3,18,37,197,262
2022-01,1701 - Department of Financial Protection and Innovation,10,2,34,38,24,575,683
2022-01,1703 - California Privacy Protection Agency,1,0,0,0,0,2,3
2022-01,1750 - California Horse Racing Board,1,4,1,8,2,11,27
2022-01,2100 - Department of Alcoholic Beverage Control,2,89,150,92,33,46,412
2022-01,2120 - Alcoholic Beverage Control Appeals Board,0,0,1,2,1,2,6
2022-01,2240 - Department of Housing and Community Development,88,9,77,81,72,529,856
2022-01,2320 - Department of Real Estate,7,24,18,136,121,22,328
2022-01,2600 - California Transportation Commission,0,0,0,4,10,23,37
2022-01,2665 - High-Speed Rail Authority,11,13,26,43,28,172,293
2022-01,2720 - California Highway Patrol,1020,0,319,0,150,0,1489
2022-01,3105 - California African-American Museum,0,0,18,0,0,0,18
2022-01,3125 - California Tahoe Conservancy,1,0,0,0,0,41,42
2022-01,3340 - California Conservation Corps,0,0,49,9,88,0,146
2022-01,3355 - Office of Energy Infrastructure Safety,0,0,0,0,0,44,44
2022-01,3360 - Energy Resources Conservation and Development Commission,0,3,9,18,43,525,598
2022-01,3480 - Department of Conservation,33,21,58,87,87,328,614
2022-01,3540 - Department of Forestry and Fire Protection,4,13,29,40,45,68,199
2022-01,3560 - State Lands Commission,2,6,5,28,14,115,170
2022-01,3600 - Department of Fish and Wildlife,665,21,52,154,111,819,1822
2022-01,3640 - Wildlife Conservation Board,16,0,1,1,0,14,32
2022-01,3720 - California Coastal Commission,0,0,0,0,178,0,178
2022-01,3760 - State Coastal Conservancy,0,0,2,3,8,41,54
2022-01,3780 - Native American Heritage Commission,0,0,1,0,0,7,8
2022-01,3790 - Department of Parks and Recreation,260,136,187,103,108,370,1164
2022-01,3810 - Santa Monica Mountains Conservancy,0,0,0,0,0,7,7
2022-01,3820 - San Francisco Bay Conservation and Development Commission,0,0,0,0,0,48,48
2022-01,3825 - San Gabriel and Lower Los Angeles Rivers and Mountains Conservancy,0,0,0,1,8,0,9
2022-01,3830 - San Joaquin River Conservancy,0,0,0,0,1,2,3
2022-01,3835 - Baldwin Hills Conservancy,0,0,0,0,1,2,3
2022-01,3840 - Delta Protection Commission,1,1,0,0,2,2,6
2022-01,3845 - San Diego River Conservancy,3,0,0,0,0,0,3
2022-01,3850 - Coachella Valley Mountains Conservancy,0,1,1,2,0,0,4
2022-01,3855 - Sierra Nevada Conservancy,0,0,3,1,7,28,39
2022-01,3860 - Department of Water Resources,39,200,235,438,677,693,2282
2022-01,3862 - Central Valley Flood Protection Board,0,1,0,4,1,38,44
2022-01,3875 - Sacramento-San Joaquin Delta Conservancy,0,0,0,0,1,10,11
2022-01,3885 - Delta Stewardship Council,0,1,1,10,14,29,55
2022-01,3900 - State Air Resources Board,9,41,76,171,456,820,1573
2022-01,3930 - Department of Pesticide Regulation,9,4,17,61,99,231,421
2022-01,3940 - State Water Resources Control Board,246,16,84,82,123,1769,2320
2022-01,3960 - Department of Toxic Substances Control,210,38,68,94,226,360,996
2022-01,3970 - Department of Resources Recycling and Recovery,39,22,27,57,118,501,764
2022-01,4100 - State Council on Developmental Disabilities,5,6,6,13,6,30,66
2022-01,4140 - Department of Health Care Access and Information,9,11,28,15,47,338,448
2022-01,4150 - Department of Managed Health Care,0,0,0,2,4,477,483
2022-01,4170 - Department of Aging,1,0,4,4,3,163,175
2022-01,4250 - California Children and Families Commission,0,0,2,32,0,2,36
2022-01,4260 - State Department of Health Care Services,703,54,248,223,756,1478,3462
2022-01,4265 - Department of Public Health,1126,24,83,112,137,2456,3938
2022-01,4300 - Department of Developmental Services,23,7,32,37,85,373,557
2022-01,4440 - Department of State Hospitals,50,149,178,87,270,282,1016
2022-01,4700 - Department of Community Services and Development,1,1,1,0,2,102,107
2022-01,4800 - California Health Benefit Exchange,20,1,33,12,2,1262,1330
2022-01,5160 - Department of Rehabilitation,110,96,403,487,258,271,1625
2022-01,5175 - Department of Child Support Services,0,15,10,17,59,488,589
2022-01,5180 - Department of Social Services,0,388,1377,614,487,2285,5151
2022-01,5225 - Department of Corrections and Rehabilitation,1368,251,571,429,573,1340,4532
2022-01,5227 - Board of State and Community Corrections,0,1,1,0,1,94,97
2022-01,5420 - Prison Industry Authority,1,10,52,108,37,44,252
2022-01,6120 - California State Library,2,27,32,14,18,52,145
2022-01,6125 - Education Audit Appeals Panel,0,0,0,1,2,0,3
2022-01,6250 - California School for the Deaf - Riverside,6,0,10,1,2,0,19
2022-01,6360 - Commission on Teacher Credentialing,3,4,4,15,39,79,144
2022-01,6870 - Board of Governors of the California Community Colleges,0,0,1,5,1,164,171
2022-01,"6980 - Student Aid Commission, California",0,0,0,0,0,138,138
2022-01,7100 - Employment Development Department,26,26,518,758,168,7298,8794
2022-01,7300 - Agricultural Labor Relations Board,4,1,4,32,6,13,60
2022-01,7320 - Public Employment Relations Board,1,4,4,17,26,21,73
2022-01,7501 - Department of Human Resources,8,6,13,20,35,217,299
2022-01,7502 - California Department of Technology,87,7,7,34,42,722,899
2022-01,7503 - State Personnel Board,0,0,2,6,13,54,75
2022-01,7504 - Office of Data and Innovation,0,0,0,0,0,19,19
2022-01,7600 - California Department of Tax and Fee Administration,21,12,114,329,521,2477,3474
2022-01,7730 - Franchise Tax Board,1514,44,91,95,577,2760,5081
2022-01,7760 - Department of General Services,381,75,81,95,185,1126,1943
2022-01,7870 - California Victim Compensation Board,2,0,10,16,151,43,222
2022-01,7910 - Office of Administrative Law,0,3,5,4,9,0,21
2022-01,7920 - State Teachers' Retirement System,0,0,0,2,2,1280,1284
2022-01,8120 - Commission on Peace Officer Standards and Training,2,2,9,0,0,119,132
2022-01,8140 - State Public Defender,9,2,13,7,5,45,81
2022-01,8560 - California Exposition and State Fair,0,0,1,0,1,0,2
2022-01,8570 - Department of Food and Agriculture,62,22,50,65,61,231,491
2022-01,8620 - Fair Political Practices Commission,0,0,0,0,2,81,83
2022-01,8660 - Public Utilities Commission,0,13,56,140,702,333,1244
2022-01,"8780 - Milton Marks ""Little Hoover"" Commission on California State Government Organization and Economy",0,0,0,0,0,7,7
2022-01,"8830 - Law Revision Commission, California",0,0,0,0,0,7,7
2022-01,8860 - Department of Finance,10,13,32,36,96,191,378
2022-01,8880 - Financial Information System for California,0,0,1,7,14,269,291
2022-01,"8885 - States Mandates, Commission on",0,0,1,0,9,1,11
2022-01,8940 - Military Department,1,0,18,36,9,6,70
2022-01,8955 - Department of Veterans Affairs,14,26,45,107,49,189,430
2022-01,A059 - California Correctional Health Care Services,149,149,447,464,247,699,2155
2022-01,A314 - California Science Center,2,2,26,0,0,2,32
2022-01,A341 - California Earthquake Authority,1,0,2,5,0,70,78
2022-01,A424 - Cradle-to-Career,0,0,0,1,0,6,7
2022-01,A541 - Board of Forestry and Fire Protection,0,0,0,0,1,0,1
2022-02,0500 - Governor's Office,14,6,18,17,20,43,118
2022-02,0509 - Governor's Office of Business and Economic Development (GO-Biz),2,5,5,5,16,88,121
2022-02,0511 - Secretary for Government Operations Agency,0,0,0,4,2,24,30
2022-02,"0515 - Secretary for Business, Consumer Services, and Housing Agency",2,0,2,3,11,36,54
2022-02,0521 - Secretary for Transportation Agency,1,0,2,0,19,0,22
2022-02,0531 - Office of Systems Integration,0,2,4,3,26,301,336
2022-02,0540 - Secretary of the Natural Resources Agency,0,0,8,1,0,76,85
2022-02,0552 - Office of the Inspector General,11,2,5,3,15,95,131
2022-02,0555 - Secretary for Environmental Protection,5,0,0,4,2,60,71
2022-02,0559 - Secretary for Labor and Workforce Development Agency,4,2,8,8,3,3,28
2022-02,0650 - Office of Planning and Research,0,2,11,10,8,90,121
2022-02,0690 - Governor's Office of Emergency Services,130,65,111,226,106,396,1034
2022-02,0820 - Department of Justice,359,321,528,511,538,1620,3877
2022-02,0855 - California Gambling Control Commission,0,0,2,3,14,19,38
2022-02,0860 - State Board of Equalization,0,0,8,0,0,152,160
2022-02,0890 - Secretary of State,8,22,40,392,0,101,563
2022-02,1045 - Cannabis Control Appeals Panel,0,1,1,0,1,5,8
2022-02,1111 - Department of Consumer Affairs,279,305,323,496,451,631,2485
2022-02,1115 - Department of Cannabis Control,14,46,22,45,24,245,396
2022-02,1700 - California Civil Rights Department,5,2,3,18,37,197,262
2022-02,1701 - Department of Financial Protection and Innovation,7,2,33,40,24,572,678
2022-02,1703 - California Privacy Protection Agency,1,0,0,0,0,4,5
2022-02,1750 - California Horse Racing Board,1,4,1,9,2,12,29
2022-02,2100 - Department of Alcoholic Beverage Control,41,87,173,65,36,52,454
2022-02,2120 - Alcoholic Beverage Control Appeals Board,0,0,1,2,1,2,6
2022-02,2240 - Department of Housing and Community Development,86,12,83,87,76,561,905
2022-02,2320 - Department of Real Estate,7,24,18,136,121,22,328
2022-02,2600 - California Transportation Commission,1,0,0,4,10,22,37
2022-02,2665 - High-Speed Rail Authority,8,12,28,42,29,171,290
2022-02,2720 - California Highway Patrol,1017,0,322,0,150,0,1489
2022-02,3105 - California African-American Museum,0,0,18,0,0,0,18
2022-02,3125 - California Tahoe Conservancy,1,0,0,0,0,41,42
2022-02,3340 - California Conservation Corps,1,13,45,16,40,40,155
2022-02,3355 - Office of Energy Infrastructure Safety,1,0,0,0,0,45,46
2022-02,3360 - Energy Resources Conservation and Development Commission,1,5,10,22,44,552,634
2022-02,3480 - Department of Conservation,33,22,61,87,88,328,619
2022-02,3540 - Department of Forestry and Fire Protection,4,17,34,47,53,72,227
2022-02,3560 - State Lands Commission,2,6,5,28,14,114,169
2022-02,3600 - Department of Fish and Wildlife,418,40,79,160,164,983,1844
2022-02,3640 - Wildlife Conservation Board,5,0,1,2,1,24,33
2022-02,3720 - California Coastal Commission,0,0,0,0,178,0,178
2022-02,3760 - State Coastal Conservancy,0,2,2,3,8,41,56
2022-02,3780 - Native American Heritage Commission,0,0,1,0,0,7,8
2022-02,3790 - Department of Parks and Recreation,224,141,166,106,109,365,1111
2022-02,3810 - Santa Monica Mountains Conservancy,0,0,0,0,0,7,7
2022-02,3820 - San Francisco Bay Conservation and Development Commission,0,0,0,0,0,48,48
2022-02,3825 - San Gabriel and Lower Los Angeles Rivers and Mountains Conservancy,0,0,0,2,6,1,9
2022-02,3830 - San Joaquin River Conservancy,0,0,0,0,1,2,3
2022-02,3835 - Baldwin Hills Conservancy,0,0,0,1,0,2,3
2022-02,3840 - Delta Protection Commission,2,1,0,0,1,3,7
2022-02,3845 - San Diego River Conservancy,3,0,0,0,0,0,3
2022-02,3850 - Coachella Valley Mountains Conservancy,0,1,1,2,0,0,4
2022-02,3855 - Sierra Nevada Conservancy,0,1,5,2,11,20,39
2022-02,3860 - Department of Water Resources,15,202,316,400,691,628,2252
2022-02,3862 - Central Valley Flood Protection Board,0,2,6,4,1,38,51
2022-02,3875 - Sacramento-San Joaquin Delta Conservancy,0,0,0,0,1,10,11
2022-02,3885 - Delta Stewardship Council,0,1,1,10,14,29,55
2022-02,3900 - State Air Resources Board,23,48,125,139,498,743,1576
2022-02,3930 - Department of Pesticide Regulation,10,4,24,42,109,231,420
2022-02,3940 - State Water Resources Control Board,281,16,85,83,124,1798,2387
2022-02,3960 - Department of Toxic Substances Control,160,31,57,105,269,385,1007
2022-02,3970 - Department of Resources Recycling and Recovery,59,18,23,48,114,480,742
2022-02,4100 - State Council on Developmental Disabilities,5,6,6,13,6,30,66
2022-02,4140 - Department of Health Care Access and Information,10,9,22,15,34,358,448
2022-02,4150 - Department of Managed Health Care,0,0,0,2,5,469,476
2022-02,4170 - Department of Aging,1,1,4,5,9,171,191
2022-02,4250 - California Children and Families Commission,0,0,2,33,0,2,37
2022-02,4260 - State Department of Health Care Services,983,56,244,255,795,1506,3839
2022-02,4265 - Department of Public Health,1126,24,83,112,137,2456,3938
2022-02,4300 - Department of Developmental Services,22,6,34,41,84,371,558
2022-02,4440 - Department of State Hospitals,83,161,172,92,280,300,1088
2022-02,4700 - Department of Community Services and Development,0,0,0,0,0,106,106
2022-02,4800 - California Health Benefit Exchange,20,9,30,55,58,1104,1276
2022-02,5160 - Department of Rehabilitation,146,93,430,482,261,275,1687
2022-02,5175 - Department of Child Support Services,0,15,10,17,59,488,589
2022-02,5180 - Department of Social Services,0,388,1377,614,487,2285,5151
2022-02,5225 - Department of Corrections and Rehabilitation,1300,250,571,427,366,1558,4472
2022-02,5227 - Board of State and Community Corrections,1,1,1,2,1,96,102
2022-02,5420 - Prison Industry Authority,7,10,45,104,35,45,246
2022-02,6120 - California State Library,3,26,32,14,17,51,143
2022-02,6125 - Education Audit Appeals Panel,0,0,0,1,2,0,3
2022-02,6250 - California School for the Deaf - Riverside,6,0,10,1,2,0,19
2022-02,6360 - Commission on Teacher Credentialing,2,4,5,14,38,78,141
2022-02,6870 - Board of Governors of the California Community Colleges,0,0,1,5,0,161,167
2022-02,"6980 - Student Aid Commission, California",0,0,0,0,0,138,138
2022-02,7100 - Employment Development Department,98,16,499,739,77,7173,8602
2022-02,7300 - Agricultural Labor Relations Board,6,1,4,34,6,11,62
2022-02,7320 - Public Employment Relations Board,1,4,4,16,26,21,72
2022-02,7501 - Department of Human Resources,7,8,10,22,92,155,294
2022-02,7502 - California Department of Technology,0,0,0,4,34,868,906
2022-02,7503 - State Personnel Board,1,0,1,2,18,53,75
2022-02,7504 - Office of Data and Innovation,0,0,0,0,0,18,18
2022-02,7600 - California Department of Tax and Fee Administration,20,11,118,321,528,2459,3457
2022-02,7730 - Franchise Tax Board,1514,44,91,93,573,2744,5059
2022-02,7760 - Department of General Services,383,72,82,97,187,1124,1945
2022-02,7870 - California Victim Compensation Board,9,0,11,16,187,3,226
2022-02,7910 - Office of Administrative Law,0,3,5,4,9,0,21
2022-02,7920 - State Teachers' Retirement System,0,0,0,2,2,1278,1282
2022-02,8120 - Commission on Peace Officer Standards and Training,3,115,9,0,0,0,127
2022-02,8140 - State Public Defender,10,2,13,7,5,45,82
2022-02,8560 - California Exposition and State Fair,0,0,1,0,1,0,2
2022-02,8570 - Department of Food and Agriculture,173,56,96,138,124,418,1005
2022-02,8620 - Fair Political Practices Commission,1,0,0,0,2,79,82
2022-02,8660 - Public Utilities Commission,2,13,56,137,168,889,1265
2022-02,"8780 - Milton Marks ""Little Hoover"" Commission on California State Government Organization and Economy",0,0,0,0,0,7,7
2022-02,"8830 - Law Revision Commission, California",0,0,0,0,0,7,7
2022-02,8860 - Department of Finance,0,0,9,81,98,192,380
2022-02,8880 - Financial Information System for California,0,2,1,7,16,266,292
2022-02,"8885 - States Mandates, Commission on",0,0,1,0,4,6,11
2022-02,8940 - Military Department,2,0,19,36,9,6,72
2022-02,8955 - Department of Veterans Affairs,14,26,45,108,50,189,432
2022-02,A059 - California Correctional Health Care Services,137,156,299,230,302,581,1705
2022-02,A314 - California Science Center,2,2,26,0,0,2,32
2022-02,A341 - California Earthquake Authority,1,0,2,3,3,71,80
2022-02,A424 - Cradle-to-Career,0,0,0,3,0,3,6
2022-02,A541 - Board of Forestry and Fire Protection,0,0,1,3,1,4,9
2022-03,0500 - Governor's Office,11,12,26,23,26,21,119
2022-03,0509 - Governor's Office of Business and Economic Development (GO-Biz),2,5,5,5,22,86,125
2022-03,0511 - Secretary for Government Operations Agency,0,0,0,4,0,27,31
2022-03,"0515 - Secretary for Business, Consumer Services, and Housing Agency",2,0,2,2,11,38,55
2022-03,0521 - Secretary for Transportation Agency,1,0,2,0,19,0,22
2022-03,0531 - Office of Systems Integration,0,2,0,7,19,312,340
2022-03,0540 - Secretary of the Natural Resources Agency,0,0,8,1,0,76,85
2022-03,0552 - Office of the Inspector General,11,3,5,3,11,97,130
2022-03,0555 - Secretary for Environmental Protection,5,0,0,4,2,60,71
2022-03,0559 - Secretary for Labor and Workforce Development Agency,4,2,8,8,3,3,28
2022-03,0650 - Office of Planning and Research,0,0,2,22,24,95,143
2022-03,0690 - Governor's Office of Emergency Services,148,77,204,152,116,350,1047
2022-03,0820 - Department of Justice,359,321,528,511,538,1620,3877
2022-03,0855 - California Gambling Control Commission,0,0,2,3,12,22,39
2022-03,0860 - State Board of Equalization,1,0,8,4,0,150,163
2022-03,0890 - Secretary of State,8,22,40,392,0,101,563
2022-03,1045 - Cannabis Control Appeals Panel,0,1,1,0,1,5,8
2022-03,1111 - Department of Consumer Affairs,299,297,367,403,426,553,2345
2022-03,1115 - Department of Cannabis Control,14,51,22,53,47,213,400
2022-03,1700 - California Civil Rights Department,5,2,3,18,37,197,262
2022-03,1701 - Department of Financial Protection and Innovation,5,3,34,39,24,582,687
2022-03,1703 - California Privacy Protection Agency,1,0,0,0,0,5,6
2022-03,1750 - California Horse Racing Board,1,4,1,9,2,12,29
2022-03,2100 - Department of Alcoholic Beverage Control,41,87,173,65,36,52,454
2022-03,2120 - Alcoholic Beverage Control Appeals Board,0,0,1,2,1,2,6
2022-03,2240 - Department of Housing and Community Development,88,12,85,91,78,574,928
2022-03,2320 - Department of Real Estate,19,14,19,133,124,22,331
2022-03,2600 - California Transportation Commission,1,1,2,7,2,23,36
2022-03,2665 - High-Speed Rail Authority,7,16,26,39,36,168,292
2022-03,2700 - California Traffic Safety Program,0,0,1,2,26,2,31
2022-03,2720 - California Highway Patrol,1014,0,326,0,150,0,1490
2022-03,3100 - Exposition Park,3,2,46,0,0,2,53
2022-03,3105 - California African-American Museum,0,0,18,0,0,0,18
2022-03,3125 - California Tahoe Conservancy,1,2,1,0,0,41,45
2022-03,3340 - California Conservation Corps,1,16,36,20,37,42,152
2022-03,3355 - Office of Energy Infrastructure Safety,4,0,0,0,0,48,52
2022-03,3360 - Energy Resources Conservation and Development Commission,1,5,11,22,46,573,658
2022-03,3480 - Department of Conservation,33,22,61,88,88,331,623
2022-03,3540 - Department of Forestry and Fire Protection,6,25,47,55,68,99,300
2022-03,3560 - State Lands Commission,2,6,5,27,14,115,169
2022-03,3600 - Department of Fish and Wildlife,384,59,94,172,187,1026,1922
2022-03,3640 - Wildlife Conservation Board,4,0,1,2,1,24,32
2022-03,3720 - California Coastal Commission,0,0,0,0,178,0,178
2022-03,3760 - State Coastal Conservancy,0,2,2,3,8,41,56
2022-03,3780 - Native American Heritage Commission,0,0,1,0,0,7,8
2022-03,3790 - Department of Parks and Recreation,222,138,172,107,112,361,1112
2022-03,3810 - Santa Monica Mountains Conservancy,0,0,0,0,0,7,7
2022-03,3820 - San Francisco Bay Conservation and Development Commission,0,0,0,0,0,48,48
2022-03,3825 - San Gabriel and Lower Los Angeles Rivers and Mountains Conservancy,0,0,0,1,7,1,9
2022-03,3830 - San Joaquin River Conservancy,0,0,0,0,1,2,3
2022-03,3835 - Baldwin Hills Conservancy,0,0,0,1,0,2,3
2022-03,3840 - Delta Protection Commission,1,1,0,0,1,4,7
2022-03,3845 - San Diego River Conservancy,3,0,0,0,0,0,3
2022-03,3850 - Coachella Valley Mountains Conservancy,0,1,1,2,0,0,4
2022-03,3855 - Sierra Nevada Conservancy,0,0,6,5,9,20,40
2022-03,3860 - Department of Water Resources,5,231,317,396,645,651,2245
2022-03,3862 - Central Valley Flood Protection Board,0,1,0,4,1,40,46
2022-03,3875 - Sacramento-San Joaquin Delta Conservancy,0,0,0,0,1,10,11
2022-03,3885 - Delta Stewardship Council,0,1,1,10,14,29,55
2022-03,3900 - State Air Resources Board,26,85,115,182,370,841,1619
2022-03,3930 - Department of Pesticide Regulation,11,13,21,51,109,220,425
2022-03,3940 - State Water Resources Control Board,339,16,83,80,125,1781,2424
2022-03,3960 - Department of Toxic Substances Control,163,37,51,129,292,334,1006
2022-03,3970 - Department of Resources Recycling and Recovery,15,11,25,86,101,512,750
2022-03,3980 - Office of Environmental Health Hazard Assessment,0,0,1,5,18,111,135
2022-03,4100 - State Council on Developmental Disabilities,5,6,6,13,6,30,66
2022-03,4140 - Department of Health Care Access and Information,74,12,113,14,54,187,454
2022-03,4150 - Department of Managed Health Care,1,0,0,3,5,471,480
2022-03,4170 - Department of Aging,3,2,4,6,9,164,188
2022-03,4250 - California Children and Families Commission,0,0,2,32,0,2,36
2022-03,4260 - State Department of Health Care Services,997,53,231,240,788,1504,3813
2022-03,4265 - Department of Public Health,1126,24,83,112,137,2456,3938
2022-03,4300 - Department of Developmental Services,3,13,22,33,88,383,542
2022-03,4440 - Department of State Hospitals,114,197,167,111,275,304,1168
2022-03,4700 - Department of Community Services and Development,1,1,0,1,2,101,106
2022-03,4800 - California Health Benefit Exchange,50,9,31,55,60,1147,1352
2022-03,5160 - Department of Rehabilitation,155,118,407,520,224,248,1672
2022-03,5175 - Department of Child Support Services,0,15,10,17,59,486,587
2022-03,5180 - Department of Social Services,0,388,1377,614,487,2285,5151
2022-03,5225 - Department of Corrections and Rehabilitation,0,253,571,533,327,1552,3236
2022-03,5227 - Board of State and Community Corrections,0,2,1,2,1,104,110
2022-03,5420 - Prison Industry Authority,4,8,50,104,34,45,245
2022-03,6120 - California State Library,4,24,27,17,20,52,144
2022-03,6125 - Education Audit Appeals Panel,0,0,0,1,2,0,3
2022-03,6250 - California School for the Deaf - Riverside,6,0,10,1,2,0,19
2022-03,6360 - Commission on Teacher Credentialing,1,4,6,14,40,78,143
2022-03,6870 - Board of Governors of the California Community Colleges,0,0,1,4,0,161,166
2022-03,"6980 - Student Aid Commission, California",0,0,0,0,0,138,138
2022-03,7100 - Employment Development Department,80,14,466,753,86,7115,8514
2022-03,7300 - Agricultural Labor Relations Board,6,1,4,34,6,11,62
2022-03,7320 - Public Employment Relations Board,3,3,7,18,25,8,64
2022-03,7501 - Department of Human Resources,10,5,14,59,59,140,287
2022-03,7502 - California Department of Technology,83,7,7,32,46,739,914
2022-03,7503 - State Personnel Board,1,1,0,4,15,54,75
2022-03,7504 - Office of Data and Innovation,0,0,0,0,0,20,20
2022-03,7600 - California Department of Tax and Fee Administration,25,13,118,337,557,2545,3595
2022-03,7730 - Franchise Tax Board,1262,53,85,146,586,2939,5071
2022-03,7760 - Department of General Services,395,74,83,94,188,1119,1953
2022-03,7870 - California Victim Compensation Board,9,0,11,16,184,4,224
2022-03,7910 - Office of Administrative Law,0,3,5,4,9,0,21
2022-03,7920 - State Teachers' Retirement System,0,0,0,2,2,1270,1274
2022-03,8120 - Commission on Peace Officer Standards and Training,2,1,127,0,0,0,130
2022-03,8140 - State Public Defender,10,2,13,9,4,43,81
2022-03,8560 - California Exposition and State Fair,0,0,1,0,1,0,2
2022-03,8570 - Department of Food and Agriculture,103,43,71,80,96,177,570
2022-03,8620 - Fair Political Practices Commission,1,0,0,0,2,79,82
2022-03,8660 - Public Utilities Commission,0,16,61,146,528,536,1287
2022-03,"8780 - Milton Marks ""Little Hoover"" Commission on California State Government Organization and Economy",0,0,0,0,0,7,7
2022-03,8825 - Commission on Asian and Pacific Islander American Affairs,0,0,0,0,0,3,3
2022-03,"8830 - Law Revision Commission, California",0,0,0,0,0,9,9
2022-03,8860 - Department of Finance,0,0,8,84,99,187,378
2022-03,8880 - Financial Information System for California,0,1,2,5,14,270,292
2022-03,"8885 - States Mandates, Commission on",0,0,1,0,4,6,11
2022-03,8940 - Military Department,2,0,20,36,10,6,74
2022-03,8955 - Department of Veterans Affairs,14,26,45,108,50,189,432
2022-03,A059 - California Correctional Health Care Services,0,208,204,339,260,624,1635
2022-03,A314 - California Science Center,3,2,25,0,0,2,32
2022-03,A341 - California Earthquake Authority,1,0,2,4,4,69,80
2022-03,A424 - Cradle-to-Career,0,0,0,3,0,3,6
2022-04,0500 - Governor's Office,11,15,25,25,23,18,117
2022-04,0509 - Governor's Office of Business and Economic Development (GO-Biz),5,5,3,4,21,90,128
2022-04,0511 - Secretary for Government Operations Agency,0,0,2,2,1,24,29
2022-04,"0515 - Secretary for Business, Consumer Services, and Housing Agency",2,0,4,2,11,39,58
2022-04,0521 - Secretary for Transportation Agency,1,0,2,0,19,0,22
2022-04,0531 - Office of Systems Integration,0,2,3,3,26,308,342
2022-04,0540 - Secretary of the Natural Resources Agency,2,4,0,11,0,67,84
2022-04,0552 - Office of the Inspector General,10,2,2,6,12,97,129
2022-04,0555 - Secretary for Environmental Protection,5,0,0,4,2,60,71
2022-04,0559 - Secretary for Labor and Workforce Development Agency,4,2,8,8,3,3,28
2022-04,0650 - Office of Planning and Research,0,0,2,22,24,98,146
2022-04,0690 - Governor's Office of Emergency Services,289,170,211,179,236,37,1122
2022-04,0820 - Department of Justice,359,321,528,511,538,1620,3877
2022-04,0845 - Department of Insurance,3,167,28,55,200,519,972
2022-04,0855 - California Gambling Control Commission,0,0,0,3,9,27,39
2022-04,0860 - State Board of Equalization,1,0,8,2,0,150,161
2022-04,0890 - Secretary of State,8,22,40,392,0,101,563
2022-04,1045 - Cannabis Control Appeals Panel,0,1,1,0,1,5,8
2022-04,1111 - Department of Consumer Affairs,279,296,391,440,469,589,2464
2022-04,1115 - Department of Cannabis Control,10,53,23,59,23,193,361
2022-04,1700 - California Civil Rights Department,5,2,3,21,36,191,258
2022-04,1701 - Department of Financial Protection and Innovation,2,4,34,39,24,584,687
2022-04,1703 - California Privacy Protection Agency,1,0,0,0,0,6,7
2022-04,1750 - California Horse Racing Board,1,4,1,8,2,11,27
2022-04,2100 - Department of Alcoholic Beverage Control,202,73,78,54,19,42,468
2022-04,2120 - Alcoholic Beverage Control Appeals Board,0,0,1,2,1,2,6
2022-04,2240 - Department of Housing and Community Development,97,13,91,94,80,608,983
2022-04,2320 - Department of Real Estate,16,12,18,126,114,22,308
2022-04,2600 - California Transportation Commission,1,1,2,7,2,23,36
2022-04,2660 - Department of Transportation,115,344,1238,5570,2717,2683,12667
2022-04,2665 - High-Speed Rail Authority,4,15,21,34,49,173,296
2022-04,2700 - California Traffic Safety Program,0,0,1,2,26,2,31
2022-04,2720 - California Highway Patrol,1011,0,328,0,146,0,1485
2022-04,3100 - Exposition Park,6,4,50,0,0,4,64
2022-04,3105 - California African-American Museum,0,0,18,0,0,0,18
2022-04,3125 - California Tahoe Conservancy,1,2,1,0,0,41,45
2022-04,3340 - California Conservation Corps,1,16,36,20,35,44,152
2022-04,3355 - Office of Energy Infrastructure Safety,1,0,0,0,0,49,50
2022-04,3360 - Energy Resources Conservation and Development Commission,1,5,11,22,45,571,655
2022-04,3480 - Department of Conservation,33,22,60,87,88,331,621
2022-04,3540 - Department of Forestry and Fire Protection,6,38,92,98,100,132,466
2022-04,3560 - State Lands Commission,2,5,5,27,14,116,169
2022-04,3600 - Department of Fish and Wildlife,370,56,103,180,185,1032,1926
2022-04,3640 - Wildlife Conservation Board,5,0,1,2,1,23,32
2022-04,3720 - California Coastal Commission,0,0,0,0,178,0,178
2022-04,3760 - State Coastal Conservancy,0,0,2,4,10,42,58
2022-04,3780 - Native American Heritage Commission,0,0,1,0,0,7,8
2022-04,3790 - Department of Parks and Recreation,209,136,165,111,121,326,1068
2022-04,3810 - Santa Monica Mountains Conservancy,0,0,0,0,0,7,7
2022-04,3820 - San Francisco Bay Conservation and Development Commission,0,0,0,0,0,47,47
2022-04,3825 - San Gabriel and Lower Los Angeles Rivers and Mountains Conservancy,0,0,0,1,7,1,9
2022-04,3830 - San Joaquin River Conservancy,0,0,0,0,1,2,3
2022-04,3835 - Baldwin Hills Conservancy,0,0,0,1,0,2,3
2022-04,3840 - Delta Protection Commission,0,1,1,0,0,5,7
2022-04,3845 - San Diego River Conservancy,3,0,0,0,0,0,3
2022-04,3850 - Coachella Valley Mountains Conservancy,0,1,1,2,0,0,4
2022-04,3855 - Sierra Nevada Conservancy,0,1,6,6,8,20,41
2022-04,3860 - Department of Water Resources,45,239,386,436,626,549,2281
2022-04,3862 - Central Valley Flood Protection Board,0,2,1,4,1,40,48
2022-04,3875 - Sacramento-San Joaquin Delta Conservancy,0,0,0,0,1,10,11
2022-04,3885 - Delta Stewardship Council,0,1,1,10,14,29,55
2022-04,3900 - State Air Resources Board,0,104,124,228,447,668,1571
2022-04,3930 - Department of Pesticide Regulation,12,12,26,60,107,209,426
2022-04,3940 - State Water Resources Control Board,545,16,75,80,118,1700,2534
2022-04,3960 - Department of Toxic Substances Control,163,58,105,50,127,514,1017
2022-04,3970 - Department of Resources Recycling and Recovery,10,12,41,101,101,484,749
2022-04,3980 - Office of Environmental Health Hazard Assessment,0,0,1,5,18,111,135
2022-04,4100 - State Council on Developmental Disabilities,5,6,6,13,6,30,66
2022-04,4140 - Department of Health Care Access and Information,75,15,114,16,51,185,456
2022-04,4150 - Department of Managed Health Care,1,0,0,3,6,474,484
2022-04,4170 - Department of Aging,5,2,3,7,9,167,193
2022-04,4250 - California Children and Families Commission,0,0,2,33,0,2,37
2022-04,4260 - State Department of Health Care Services,1069,53,228,235,774,1480,3839
2022-04,4265 - Department of Public Health,1126,24,83,112,137,2456,3938
2022-04,4300 - Department of Developmental Services,20,13,22,33,91,379,558
2022-04,4440 - Department of State Hospitals,120,191,175,128,280,307,1201
2022-04,4700 - Department of Community Services and Development,1,1,0,5,2,101,110
2022-04,4800 - California Health Benefit Exchange,54,9,34,47,61,1141,1346
2022-04,5160 - Department of Rehabilitation,154,105,423,516,222,249,1669
2022-04,5175 - Department of Child Support Services,0,16,10,17,59,489,591
2022-04,5180 - Department of Social Services,0,388,1377,614,487,2285,5151
2022-04,5225 - Department of Corrections and Rehabilitation,0,32,81,64,31,162,370
2022-04,5227 - Board of State and Community Corrections,0,2,1,2,1,107,113
2022-04,5420 - Prison Industry Authority,1,7,46,95,34,36,219
2022-04,6120 - California State Library,4,24,28,16,20,52,144
2022-04,6125 - Education Audit Appeals Panel,0,0,0,1,2,0,3
2022-04,6250 - California School for the Deaf - Riverside,6,0,10,1,2,0,19
2022-04,6360 - Commission on Teacher Credentialing,5,1,8,16,39,78,147
2022-04,6870 - Board of Governors of the California Community Colleges,0,0,1,4,0,160,165
2022-04,"6980 - Student Aid Commission, California",0,0,0,0,0,138,138
2022-04,7100 - Employment Development Department,0,0,405,749,0,6960,8114
2022-04,7300 - Agricultural Labor Relations Board,5,1,4,36,6,10,62
2022-04,7320 - Public Employment Relations Board,3,3,6,18,25,8,63
2022-04,7501 - Department of Human Resources,13,6,16,56,57,139,287
2022-04,7502 - California Department of Technology,78,7,7,29,45,753,919
2022-04,7503 - State Personnel Board,0,2,0,5,11,56,74
2022-04,7504 - Office of Data and Innovation,0,0,0,0,0,22,22
2022-04,7600 - California Department of Tax and Fee Administration,8,12,109,346,557,2542,3574
2022-04,7730 - Franchise Tax Board,1262,54,87,211,588,2934,5136
2022-04,7760 - Department of General Services,398,75,82,97,190,1112,1954
2022-04,7870 - California Victim Compensation Board,6,0,10,16,194,1,227
2022-04,7910 - Office of Administrative Law,0,3,5,4,9,0,21
2022-04,7920 - State Teachers' Retirement System,0,12,211,910,73,39,1245
2022-04,8120 - Commission on Peace Officer Standards and Training,1,2,122,1,0,0,126
2022-04,8140 - State Public Defender,10,2,14,9,4,42,81
2022-04,8560 - California Exposition and State Fair,0,0,1,0,1,0,2
2022-04,8570 - Department of Food and Agriculture,116,39,57,88,125,157,582
2022-04,8620 - Fair Political Practices Commission,1,0,0,0,2,79,82
2022-04,8660 - Public Utilities Commission,0,16,61,146,528,536,1287
2022-04,"8780 - Milton Marks ""Little Hoover"" Commission on California State Government Organization and Economy",0,0,0,0,0,7,7
2022-04,8825 - Commission on Asian and Pacific Islander American Affairs,0,0,0,0,0,3,3
2022-04,"8830 - Law Revision Commission, California",0,0,0,0,0,9,9
2022-04,8860 - Department of Finance,0,0,7,340,0,24,371
2022-04,8880 - Financial Information System for California,1,0,4,3,15,270,293
2022-04,"8885 - States Mandates, Commission on",0,0,1,0,2,8,11
2022-04,8940 - Military Department,2,2,22,39,12,6,83
2022-04,8955 - Department of Veterans Affairs,14,26,45,108,50,189,432
2022-04,A059 - California Correctional Health Care Services,0,223,173,251,186,410,1243
2022-04,A314 - California Science Center,3,2,24,0,0,2,31
2022-04,A341 - California Earthquake Authority,1,0,2,3,4,69,79
2022-04,A424 - Cradle-to-Career,0,0,0,3,0,3,6
2022-04,A541 - Board of Forestry and Fire Protection,0,0,0,2,3,5,10
2022-05,0500 - Governor's Office,18,14,28,22,18,20,120
2022-05,0509 - Governor's Office of Business and Economic Development (GO-Biz),7,4,3,3,21,89,127
2022-05,0511 - Secretary for Government Operations Agency,0,0,2,1,1,21,25
2022-05,"0515 - Secretary for Business, Consumer Services, and Housing Agency",2,0,4,2,11,39,58
2022-05,0521 - Secretary for Transportation Agency,1,0,2,0,19,0,22
2022-05,0531 - Office of Systems Integration,0,2,3,3,26,312,346
2022-05,0540 - Secretary of the Natural Resources Agency,2,4,1,11,0,68,86
2022-05,0552 - Office of the Inspector General,10,4,2,1,12,102,131
2022-05,0555 - Secretary for Environmental Protection,0,0,0,0,0,72,72
2022-05,0559 - Secretary for Labor and Workforce Development Agency,4,2,8,8,3,3,28
2022-05,0650 - Office of Planning and Research,0,0,2,25,25,98,150
2022-05,0690 - Governor's Office of Emergency Services,339,237,195,258,109,0,1138
2022-05,0820 - Department of Justice,359,321,528,511,538,1620,3877
2022-05,0845 - Department of Insurance,5,176,32,58,200,504,975
2022-05,0855 - California Gambling Control Commission,0,0,0,3,10,26,39
2022-05,0860 - State Board of Equalization,0,1,15,106,1,35,158
2022-05,0890 - Secretary of State,8,22,40,392,0,101,563
2022-05,1045 - Cannabis Control Appeals Panel,1,0,2,0,1,4,8
2022-05,1111 - Department of Consumer Affairs,254,296,404,415,451,545,2365
2022-05,1115 - Department of Cannabis Control,10,57,24,63,24,197,375
2022-05,1700 - California Civil Rights Department,5,2,3,21,36,191,258
2022-05,1701 - Department of Financial Protection and Innovation,2,4,34,36,67,543,686
2022-05,1703 - California Privacy Protection Agency,1,0,0,0,0,6,7
2022-05,1750 - California Horse Racing Board,1,4,1,8,2,11,27
2022-05,2100 - Department of Alcoholic Beverage Control,188,78,81,56,21,45,469
2022-05,2120 - Alcoholic Beverage Control Appeals Board,0,0,1,2,1,2,6
2022-05,2240 - Department of Housing and Community Development,96,13,92,96,76,615,988
2022-05,2320 - Department of Real Estate,21,14,22,126,123,23,329
2022-05,2600 - California Transportation Commission,1,1,2,8,2,23,37
2022-05,2660 - Department of Transportation,118,351,1244,5580,2720,2086,12099
2022-05,2665 - High-Speed Rail Authority,1,16,12,38,65,135,267
2022-05,2700 - California Traffic Safety Program,0,0,1,2,25,2,30
2022-05,2720 - California Highway Patrol,1004,0,336,0,144,0,1484
2022-05,3100 - Exposition Park,3,2,43,0,0,2,50
2022-05,3105 - California African-American Museum,0,0,18,0,0,0,18
2022-05,3125 - California Tahoe Conservancy,1,2,1,0,0,41,45
2022-05,3340 - California Conservation Corps,1,16,37,20,34,43,151
2022-05,3355 - Office of Energy Infrastructure Safety,1,0,0,0,0,50,51
2022-05,3360 - Energy Resources Conservation and Development Commission,1,6,10,23,47,574,661
2022-05,3480 - Department of Conservation,32,21,59,87,87,330,616
2022-05,3540 - Department of Forestry and Fire Protection,5,48,109,121,105,157,545
2022-05,3560 - State Lands Commission,2,5,5,29,14,115,170
2022-05,3600 - Department of Fish and Wildlife,360,55,136,189,182,1003,1925
2022-05,3640 - Wildlife Conservation Board,7,0,0,2,1,22,32
2022-05,3720 - California Coastal Commission,0,0,0,0,178,0,178
2022-05,3760 - State Coastal Conservancy,0,0,2,4,10,41,57
2022-05,3780 - Native American Heritage Commission,0,0,1,0,0,7,8
2022-05,3790 - Department of Parks and Recreation,201,120,190,96,205,264,1076
2022-05,3810 - Santa Monica Mountains Conservancy,0,0,0,0,0,7,7
2022-05,3820 - San Francisco Bay Conservation and Development Commission,0,0,0,0,0,47,47
2022-05,3825 - San Gabriel and Lower Los Angeles Rivers and Mountains Conservancy,0,0,0,1,8,1,10
2022-05,3830 - San Joaquin River Conservancy,0,0,0,0,1,2,3
2022-05,3835 - Baldwin Hills Conservancy,0,0,0,1,0,2,3
2022-05,3840 - Delta Protection Commission,0,1,1,0,0,5,7
2022-05,3845 - San Diego River Conservancy,3,0,0,0,0,0,3
2022-05,3850 - Coachella Valley Mountains Conservancy,0,1,1,2,0,0,4
2022-05,3855 - Sierra Nevada Conservancy,0,0,7,5,10,20,42
2022-05,3860 - Department of Water Resources,33,261,383,434,632,580,2323
2022-05,3862 - Central Valley Flood Protection Board,0,2,1,4,6,37,50
2022-05,3875 - Sacramento-San Joaquin Delta Conservancy,0,0,0,0,1,10,11
2022-05,3885 - Delta Stewardship Council,0,1,1,6,10,44,62
2022-05,3900 - State Air Resources Board,14,36,38,114,221,1130,1553
2022-05,3930 - Department of Pesticide Regulation,10,9,22,69,104,208,422
2022-05,3940 - State Water Resources Control Board,14,41,270,255,568,895,2043
2022-05,3960 - Department of Toxic Substances Control,192,37,108,91,181,406,1015
2022-05,3970 - Department of Resources Recycling and Recovery,10,16,31,100,105,483,745
2022-05,3980 - Office of Environmental Health Hazard Assessment,0,0,1,5,18,111,135
2022-05,4100 - State Council on Developmental Disabilities,5,6,6,13,6,30,66
2022-05,4140 - Department of Health Care Access and Information,76,17,113,17,49,190,462
2022-05,4150 - Department of Managed Health Care,2,0,0,3,5,474,484
2022-05,4170 - Department of Aging,6,2,4,9,9,170,200
2022-05,4250 - California Children and Families Commission,0,0,2,33,0,2,37
2022-05,4260 - State Department of Health Care Services,698,70,228,272,915,1652,3835
2022-05,4265 - Department of Public Health,1126,24,83,112,137,2456,3938
2022-05,4300 - Department of Developmental Services,23,9,28,39,88,376,563
2022-05,4440 - Department of State Hospitals,112,201,162,99,280,332,1186
2022-05,4700 - Department of Community Services and Development,2,1,2,5,3,100,113
2022-05,4800 - California Health Benefit Exchange,40,13,33,55,62,1159,1362
2022-05,5160 - Department of Rehabilitation,137,133,412,502,241,247,1672
2022-05,5175 - Department of Child Support Services,0,14,13,7,82,449,565
2022-05,5180 - Department of Social Services,0,388,1377,614,487,2285,5151
2022-05,5225 - Department of Corrections and Rehabilitation,0,263,555,562,303,1577,3260
2022-05,5227 - Board of State and Community Corrections,0,3,1,0,2,108,114
2022-05,5420 - Prison Industry Authority,3,6,48,99,46,42,244
2022-05,6120 - California State Library,4,24,28,16,20,53,145
2022-05,6125 - Education Audit Appeals Panel,0,0,0,1,2,0,3
2022-05,6250 - California School for the Deaf - Riverside,6,0,10,1,2,0,19
2022-05,6360 - Commission on Teacher Credentialing,6,2,8,14,39,77,146
2022-05,6870 - Board of Governors of the California Community Colleges,0,0,1,4,1,161,167
2022-05,"6980 - Student Aid Commission, California",5,1,1,10,21,90,128
2022-05,7100 - Employment Development Department,0,0,412,749,0,6752,7913
2022-05,7300 - Agricultural Labor Relations Board,4,1,4,36,6,10,61
2022-05,7320 - Public Employment Relations Board,3,3,6,18,26,8,64
2022-05,7501 - Department of Human Resources,13,6,16,56,57,139,287
2022-05,7502 - California Department of Technology,62,7,7,30,47,769,922
2022-05,7503 - State Personnel Board,0,1,0,3,12,58,74
2022-05,7504 - Office of Data and Innovation,0,0,0,0,0,22,22
2022-05,7600 - California Department of Tax and Fee Administration,8,13,109,349,556,2534,3569
2022-05,7730 - Franchise Tax Board,550,95,1055,3072,138,151,5061
2022-05,7760 - Department of General Services,401,70,80,104,164,1129,1948
2022-05,7870 - California Victim Compensation Board,5,0,10,16,199,1,231
2022-05,7910 - Office of Administrative Law,0,3,5,4,9,0,21
2022-05,7920 - State Teachers' Retirement System,0,12,212,909,72,39,1244
2022-05,8120 - Commission on Peace Officer Standards and Training,1,1,126,0,1,0,129
2022-05,8140 - State Public Defender,8,2,13,10,4,41,78
2022-05,8560 - California Exposition and State Fair,0,0,1,0,1,0,2
2022-05,8570 - Department of Food and Agriculture,116,44,73,83,109,176,601
2022-05,8620 - Fair Political Practices Commission,1,0,0,0,2,79,82
2022-05,8660 - Public Utilities Commission,0,16,61,146,528,536,1287
2022-05,"8780 - Milton Marks ""Little Hoover"" Commission on California State Government Organization and Economy",0,0,0,0,0,7,7
2022-05,8825 - Commission on Asian and Pacific Islander American Affairs,0,0,0,0,0,3,3
2022-05,"8830 - Law Revision Commission, California",0,0,0,0,0,9,9
2022-05,8860 - Department of Finance,0,0,6,354,0,24,384
2022-05,8880 - Financial Information System for California,0,0,0,0,292,1,293
2022-05,"8885 - States Mandates, Commission on",0,0,1,0,2,9,12
2022-05,8940 - Military Department,2,2,22,39,12,6,83
2022-05,8955 - Department of Veterans Affairs,14,26,45,108,50,189,432
2022-05,A059 - California Correctional Health Care Services,2,260,323,504,266,828,2183
2022-05,A314 - California Science Center,2,2,25,0,0,2,31
2022-05,A341 - California Earthquake Authority,1,0,3,2,4,68,78
2022-05,A424 - Cradle-to-Career,0,0,0,3,0,3,6
2022-05,A541 - Board of Forestry and Fire Protection,0,0,1,2,4,5,12
2022-06,0500 - Governor's Office,16,13,27,27,18,20,121
2022-06,0509 - Governor's Office of Business and Economic Development (GO-Biz),1,7,4,8,9,90,119
2022-06,0511 - Secretary for Government Operations Agency,0,0,0,3,1,22,26
2022-06,"0515 - Secretary for Business, Consumer Services, and Housing Agency",2,0,6,5,10,32,55
2022-06,0521 - Secretary for Transportation Agency,0,0,2,15,0,1,18
2022-06,0531 - Office of Systems Integration,6,2,1,7,15,320,351
2022-06,0540 - Secretary of the Natural Resources Agency,1,5,1,11,0,64,82
2022-06,0552 - Office of the Inspector General,7,2,1,3,17,96,126
2022-06,0555 - Secretary for Environmental Protection,0,0,0,0,0,72,72
2022-06,0559 - Secretary for Labor and Workforce Development Agency,4,2,8,8,3,3,28
2022-06,0650 - Office of Planning and Research,1,0,2,23,25,111,162
2022-06,0690 - Governor's Office of Emergency Services,0,185,212,171,238,30,836
2022-06,0820 - Department of Justice,359,321,528,511,538,1620,3877
2022-06,0845 - Department of Insurance,5,177,32,58,202,505,979
2022-06,0855 - California Gambling Control Commission,2,0,0,7,7,22,38
2022-06,0860 - State Board of Equalization,3,1,15,112,2,28,161
2022-06,0890 - Secretary of State,8,22,40,392,0,101,563
2022-06,0911 - Citizens Redistricting Commission,0,0,0,2,1,4,7
2022-06,1045 - Cannabis Control Appeals Panel,1,0,2,0,1,4,8
2022-06,1111 - Department of Consumer Affairs,227,261,328,332,434,430,2012
2022-06,1115 - Department of Cannabis Control,2,56,19,40,26,192,335
2022-06,1700 - California Civil Rights Department,5,1,3,21,34,196,260
2022-06,1701 - Department of Financial Protection and Innovation,0,5,32,20,55,562,674
2022-06,1703 - California Privacy Protection Agency,1,0,0,0,0,7,8
2022-06,1750 - California Horse Racing Board,1,4,1,8,2,11,27
2022-06,2100 - Department of Alcoholic Beverage Control,177,87,90,58,24,47,483
2022-06,2120 - Alcoholic Beverage Control Appeals Board,0,0,1,2,1,2,6
2022-06,2240 - Department of Housing and Community Development,93,12,93,97,76,611,982
2022-06,2320 - Department of Real Estate,22,14,21,126,123,24,330
2022-06,2600 - California Transportation Commission,0,1,2,8,2,24,37
2022-06,2660 - Department of Transportation,118,351,1244,5580,2720,2086,12099
2022-06,2665 - High-Speed Rail Authority,3,9,14,24,48,169,267
2022-06,2700 - California Traffic Safety Program,0,0,0,1,27,1,29
2022-06,2720 - California Highway Patrol,1004,0,334,0,142,0,1480
2022-06,3100 - Exposition Park,2,2,27,0,0,2,33
2022-06,3105 - California African-American Museum,0,0,18,0,0,0,18
2022-06,3125 - California Tahoe Conservancy,6,1,11,6,4,18,46
2022-06,3340 - California Conservation Corps,0,18,29,23,29,44,143
2022-06,3355 - Office of Energy Infrastructure Safety,1,0,0,0,0,47,48
2022-06,3360 - Energy Resources Conservation and Development Commission,1,5,11,24,48,580,669
2022-06,3480 - Department of Conservation,29,10,60,91,51,393,634
2022-06,3540 - Department of Forestry and Fire Protection,5,51,123,135,116,175,605
2022-06,3560 - State Lands Commission,2,5,4,29,14,114,168
2022-06,3600 - Department of Fish and Wildlife,340,54,129,187,181,1004,1895
2022-06,3640 - Wildlife Conservation Board,7,0,0,2,1,20,30
2022-06,3720 - California Coastal Commission,2,6,8,38,57,48,159
2022-06,3760 - State Coastal Conservancy,0,0,2,4,10,42,58
2022-06,3780 - Native American Heritage Commission,0,0,1,0,0,7,8
2022-06,3790 - Department of Parks and Recreation,221,101,155,108,199,311,1095
2022-06,3810 - Santa Monica Mountains Conservancy,0,0,0,0,0,6,6
2022-06,3820 - San Francisco Bay Conservation and Development Commission,0,0,0,0,0,47,47
2022-06,3825 - San Gabriel and Lower Los Angeles Rivers and Mountains Conservancy,0,0,0,1,8,1,10
2022-06,3830 - San Joaquin River Conservancy,0,0,0,0,1,2,3
2022-06,3835 - Baldwin Hills Conservancy,0,0,0,1,1,1,3
2022-06,3840 - Delta Protection Commission,0,1,1,0,0,4,6
2022-06,3845 - San Diego River Conservancy,3,0,0,0,0,0,3
2022-06,3850 - Coachella Valley Mountains Conservancy,0,1,1,1,0,0,3
2022-06,3855 - Sierra Nevada Conservancy,0,0,6,7,9,21,43
2022-06,3860 - Department of Water Resources,22,96,512,854,347,185,2016
2022-06,3862 - Central Valley Flood Protection Board,0,6,2,5,16,21,50
2022-06,3875 - Sacramento-San Joaquin Delta Conservancy,0,0,0,1,3,7,11
2022-06,3885 - Delta Stewardship Council,0,1,1,6,10,45,63
2022-06,3900 - State Air Resources Board,37,130,207,496,618,73,1561
2022-06,3930 - Department of Pesticide Regulation,3,6,25,89,97,188,408
2022-06,3940 - State Water Resources Control Board,17,40,285,246,566,910,2064
2022-06,3960 - Department of Toxic Substances Control,212,31,58,118,231,378,1028
2022-06,3970 - Department of Resources Recycling and Recovery,1,13,27,46,88,445,620
2022-06,3980 - Office of Environmental Health Hazard Assessment,0,0,1,5,20,109,135
2022-06,4100 - State Council on Developmental Disabilities,5,6,6,13,6,30,66
2022-06,4140 - Department of Health Care Access and Information,70,20,115,21,49,192,467
2022-06,4150 - Department of Managed Health Care,63,0,0,5,5,451,524
2022-06,4170 - Department of Aging,5,1,8,7,14,173,208
2022-06,4250 - California Children and Families Commission,0,0,2,35,0,1,38
2022-06,4260 - State Department of Health Care Services,631,63,211,265,889,1739,3798
2022-06,4265 - Department of Public Health,1126,24,83,112,137,2456,3938
2022-06,4300 - Department of Developmental Services,24,10,29,41,92,382,578
2022-06,4440 - Department of State Hospitals,0,183,154,77,274,327,1015
2022-06,4560 - Mental Health Services Oversight and Accountability Commission,7,3,8,10,15,7,50
2022-06,4700 - Department of Community Services and Development,2,2,3,6,3,101,117
2022-06,4800 - California Health Benefit Exchange,43,9,35,55,62,1159,1363
2022-06,5160 - Department of Rehabilitation,142,134,391,506,228,244,1645
2022-06,5175 - Department of Child Support Services,0,12,12,7,89,426,546
2022-06,5180 - Department of Social Services,0,359,1179,494,403,1566,4001
2022-06,5225 - Department of Corrections and Rehabilitation,0,35,78,75,34,185,407
2022-06,5227 - Board of State and Community Corrections,1,2,1,2,93,17,116
2022-06,5420 - Prison Industry Authority,17,4,49,101,41,6,218
2022-06,6120 - California State Library,4,23,27,16,21,52,143
2022-06,6125 - Education Audit Appeals Panel,0,0,0,1,2,0,3
2022-06,6250 - California School for the Deaf - Riverside,5,0,9,1,2,0,17
2022-06,6360 - Commission on Teacher Credentialing,19,6,10,20,35,73,163
2022-06,6870 - Board of Governors of the California Community Colleges,0,0,1,5,3,168,177
2022-06,"6980 - Student Aid Commission, California",5,1,1,10,21,90,128
2022-06,7100 - Employment Development Department,0,0,409,716,0,6667,7792
2022-06,7300 - Agricultural Labor Relations Board,4,1,5,34,6,10,60
2022-06,7320 - Public Employment Relations Board,2,3,6,18,25,8,62
2022-06,7501 - Department of Human Resources,6,3,16,60,35,135,255
2022-06,7502 - California Department of Technology,64,6,7,30,48,772,927
2022-06,7503 - State Personnel Board,1,0,0,3,16,53,73
2022-06,7504 - Office of Data and Innovation,0,0,0,0,0,21,21
2022-06,7600 - California Department of Tax and Fee Administration,14,15,108,347,576,2538,3598
2022-06,7730 - Franchise Tax Board,471,115,995,3225,208,180,5194
2022-06,7760 - Department of General Services,363,69,72,101,174,982,1761
2022-06,7870 - California Victim Compensation Board,2,0,10,16,198,1,227
2022-06,7910 - Office of Administrative Law,0,2,6,6,7,2,23
2022-06,7920 - State Teachers' Retirement System,0,12,211,912,71,39,1245
2022-06,8120 - Commission on Peace Officer Standards and Training,5,0,115,0,0,2,122
2022-06,8140 - State Public Defender,11,2,15,9,4,43,84
2022-06,8570 - Department of Food and Agriculture,121,40,77,96,146,185,665
2022-06,8620 - Fair Political Practices Commission,1,0,0,0,2,79,82
2022-06,8660 - Public Utilities Commission,10,4,14,20,35,1047,1130
2022-06,"8780 - Milton Marks ""Little Hoover"" Commission on California State Government Organization and Economy",0,0,0,0,0,7,7
2022-06,8825 - Commission on Asian and Pacific Islander American Affairs,0,0,0,0,0,3,3
2022-06,"8830 - Law Revision Commission, California",0,0,0,0,0,8,8
2022-06,8860 - Department of Finance,7,8,30,278,28,38,389
2022-06,8880 - Financial Information System for California,2,0,0,15,273,1,291
2022-06,"8885 - States Mandates, Commission on",0,0,1,0,2,9,12
2022-06,8940 - Military Department,2,2,22,40,12,6,84
2022-06,8955 - Department of Veterans Affairs,30,23,59,126,91,124,453
2022-06,A059 - California Correctional Health Care Services,13,328,382,538,300,906,2467
2022-06,A314 - California Science Center,2,2,26,0,0,2,32
2022-06,A341 - California Earthquake Authority,1,0,3,2,4,66,76
2022-06,A424 - Cradle-to-Career,0,0,0,3,0,3,6
2022-06,A541 - Board of Forestry and Fire Protection,0,0,1,3,3,5,12
2022-07,0500 - Governor's Office,17,15,29,29,17,23,130
2022-07,0509 - Governor's Office of Business and Economic Development (GO-Biz),1,7,4,10,9,88,119
2022-07,0511 - Secretary for Government Operations Agency,0,0,0,9,6,5,20
2022-07,"0515 - Secretary for Business, Consumer Services, and Housing Agency",2,0,6,5,10,35,58
2022-07,0521 - Secretary for Transportation Agency,0,0,2,15,0,1,18
2022-07,0531 - Office of Systems Integration,6,2,1,7,15,316,347
2022-07,0540 - Secretary of the Natural Resources Agency,1,2,1,10,0,71,85
2022-07,0552 - Office of the Inspector General,9,2,3,3,6,103,126
2022-07,0555 - Secretary for Environmental Protection,0,0,0,0,0,72,72
2022-07,0559 - Secretary for Labor and Workforce Development Agency,4,2,8,8,3,3,28
2022-07,0650 - Office of Planning and Research,1,0,11,22,32,85,151
2022-07,0690 - Governor's Office of Emergency Services,448,117,187,174,168,230,1324
2022-07,0820 - Department of Justice,399,195,322,321,350,1021,2608
2022-07,0845 - Department of Insurance,5,176,33,59,202,509,984
2022-07,0855 - California Gambling Control Commission,2,0,0,7,7,22,38
2022-07,0860 - State Board of Equalization,1,1,16,114,2,27,161
2022-07,0890 - Secretary of State,8,22,40,390,0,101,561
2022-07,0911 - Citizens Redistricting Commission,0,0,0,2,1,4,7
2022-07,1045 - Cannabis Control Appeals Panel,1,0,2,0,1,4,8
2022-07,1111 - Department of Consumer Affairs,227,261,328,332,434,430,2012
2022-07,1115 - Department of Cannabis Control,3,64,12,41,31,196,347
2022-07,1700 - California Civil Rights Department,5,1,3,21,36,205,271
2022-07,1701 - Department of Financial Protection and Innovation,1,7,32,21,58,563,682
2022-07,1703 - California Privacy Protection Agency,1,0,0,0,0,7,8
2022-07,1750 - California Horse Racing Board,1,4,1,9,2,11,28
2022-07,2100 - Department of Alcoholic Beverage Control,164,95,92,61,25,48,485
2022-07,2120 - Alcoholic Beverage Control Appeals Board,0,0,1,2,1,2,6
2022-07,2240 - Department of Housing and Community Development,94,15,99,96,82,632,1018
2022-07,2320 - Department of Real Estate,4,15,29,155,80,24,307
2022-07,2600 - California Transportation Commission,0,1,2,8,2,23,36
2022-07,2660 - Department of Transportation,118,351,1244,5580,2720,2086,12099
2022-07,2665 - High-Speed Rail Authority,4,26,21,29,55,181,316
2022-07,2700 - California Traffic Safety Program,0,0,0,1,27,1,29
2022-07,2720 - California Highway Patrol,1008,0,329,0,137,0,1474
2022-07,3100 - Exposition Park,2,2,27,0,0,2,33
2022-07,3105 - California African-American Museum,0,0,18,0,0,0,18
2022-07,3125 - California Tahoe Conservancy,6,1,11,6,4,18,46
2022-07,3340 - California Conservation Corps,1,19,23,25,30,41,139
2022-07,3355 - Office of Energy Infrastructure Safety,2,0,0,0,0,47,49
2022-07,3360 - Energy Resources Conservation and Development Commission,1,5,11,24,47,584,672
2022-07,3480 - Department of Conservation,29,10,61,90,52,393,635
2022-07,3540 - Department of Forestry and Fire Protection,6,51,122,132,113,171,595
2022-07,3560 - State Lands Commission,2,6,13,17,26,94,158
2022-07,3600 - Department of Fish and Wildlife,322,62,159,176,188,1011,1918
2022-07,3640 - Wildlife Conservation Board,4,0,0,2,1,22,29
2022-07,3720 - California Coastal Commission,2,6,8,39,60,47,162
2022-07,3760 - State Coastal Conservancy,0,0,2,2,15,43,62
2022-07,3780 - Native American Heritage Commission,0,0,1,0,0,7,8
2022-07,3790 - Department of Parks and Recreation,220,39,135,105,175,261,935
2022-07,3810 - Santa Monica Mountains Conservancy,0,0,0,0,0,7,7
2022-07,3820 - San Francisco Bay Conservation and Development Commission,0,0,0,0,0,47,47
2022-07,3825 - San Gabriel and Lower Los Angeles Rivers and Mountains Conservancy,0,0,0,1,8,1,10
2022-07,3830 - San Joaquin River Conservancy,0,0,0,0,1,2,3
2022-07,3835 - Baldwin Hills Conservancy,0,0,0,1,1,1,3
2022-07,3840 - Delta Protection Commission,0,1,1,0,0,3,5
2022-07,3845 - San Diego River Conservancy,3,0,0,0,0,0,3
2022-07,3850 - Coachella Valley Mountains Conservancy,0,1,1,1,0,0,3
2022-07,3855 - Sierra Nevada Conservancy,0,0,7,9,10,19,45
2022-07,3860 - Department of Water Resources,22,110,575,887,367,196,2157
2022-07,3862 - Central Valley Flood Protection Board,0,6,2,7,15,21,51
2022-07,3875 - Sacramento-San Joaquin Delta Conservancy,0,0,1,0,8,5,14
2022-07,3885 - Delta Stewardship Council,0,1,1,6,10,45,63
2022-07,3900 - State Air Resources Board,14,36,38,114,221,1253,1676
2022-07,3930 - Department of Pesticide Regulation,5,6,25,93,99,193,421
2022-07,3940 - State Water Resources Control Board,17,40,295,249,578,919,2098
2022-07,3960 - Department of Toxic Substances Control,189,40,84,166,328,238,1045
2022-07,3970 - Department of Resources Recycling and Recovery,1,18,28,44,91,422,604
2022-07,3980 - Office of Environmental Health Hazard Assessment,0,0,1,5,20,109,135
2022-07,4100 - State Council on Developmental Disabilities,3,6,5,12,4,30,60
2022-07,4140 - Department of Health Care Access and Information,68,20,115,22,53,187,465
2022-07,4150 - Department of Managed Health Care,0,0,0,12,5,600,617
2022-07,4170 - Department of Aging,3,1,9,10,13,177,213
2022-07,4250 - California Children and Families Commission,0,0,2,35,0,1,38
2022-07,4260 - State Department of Health Care Services,517,65,201,278,941,1811,3813
2022-07,4265 - Department of Public Health,1126,24,83,112,137,2456,3938
2022-07,4300 - Department of Developmental Services,21,11,29,46,93,379,579
2022-07,4440 - Department of State Hospitals,1,282,162,116,272,331,1164
2022-07,4560 - Mental Health Services Oversight and Accountability Commission,7,3,8,10,15,7,50
2022-07,4700 - Department of Community Services and Development,2,0,2,4,3,107,118
2022-07,4800 - California Health Benefit Exchange,39,12,35,51,66,1179,1382
2022-07,5160 - Department of Rehabilitation,149,134,390,503,231,243,1650
2022-07,5175 - Department of Child Support Services,0,12,12,11,90,437,562
2022-07,5180 - Department of Social Services,0,359,1179,494,403,1566,4001
2022-07,5225 - Department of Corrections and Rehabilitation,0,35,78,75,34,185,407
2022-07,5227 - Board of State and Community Corrections,9,1,1,8,87,11,117
2022-07,5420 - Prison Industry Authority,20,4,48,100,41,6,219
2022-07,6120 - California State Library,3,22,27,16,21,54,143
2022-07,6125 - Education Audit Appeals Panel,0,0,0,1,2,0,3
2022-07,6250 - California School for the Deaf - Riverside,5,0,9,1,2,0,17
2022-07,6360 - Commission on Teacher Credentialing,20,7,12,19,36,65,159
2022-07,6870 - Board of Governors of the California Community Colleges,0,0,1,5,3,164,173
2022-07,"6980 - Student Aid Commission, California",5,1,1,10,21,90,128
2022-07,7100 - Employment Development Department,0,0,555,1632,0,6144,8331
2022-07,7300 - Agricultural Labor Relations Board,5,0,5,32,6,8,56
2022-07,7320 - Public Employment Relations Board,2,3,6,18,25,8,62
2022-07,7501 - Department of Human Resources,7,3,16,64,52,137,279
2022-07,7502 - California Department of Technology,63,6,7,31,47,767,921
2022-07,7503 - State Personnel Board,0,2,0,1,14,57,74
2022-07,7504 - Office of Data and Innovation,0,0,0,0,0,24,24
2022-07,7600 - California Department of Tax and Fee Administration,15,14,107,354,592,2500,3582
2022-07,7730 - Franchise Tax Board,469,115,970,3237,229,186,5206
2022-07,7760 - Department of General Services,339,84,108,123,190,979,1823
2022-07,7870 - California Victim Compensation Board,2,0,13,15,195,1,226
2022-07,7910 - Office of Administrative Law,0,2,6,6,7,2,23
2022-07,7920 - State Teachers' Retirement System,22,8,230,951,36,3,1250
2022-07,8120 - Commission on Peace Officer Standards and Training,5,0,117,0,0,2,124
2022-07,8140 - State Public Defender,11,2,14,10,4,43,84
2022-07,8570 - Department of Food and Agriculture,96,35,63,93,130,172,589
2022-07,8620 - Fair Political Practices Commission,1,0,2,8,16,55,82
2022-07,8660 - Public Utilities Commission,10,4,14,20,35,1047,1130
2022-07,"8780 - Milton Marks ""Little Hoover"" Commission on California State Government Organization and Economy",0,0,0,1,0,5,6
2022-07,8825 - Commission on Asian and Pacific Islander American Affairs,0,0,0,0,0,3,3
2022-07,"8830 - Law Revision Commission, California",0,0,0,0,0,8,8
2022-07,8860 - Department of Finance,7,8,29,275,28,38,385
2022-07,8880 - Financial Information System for California,1,0,6,2,8,273,290
2022-07,"8885 - States Mandates, Commission on",0,0,1,0,2,9,12
2022-07,8940 - Military Department,3,2,24,41,12,6,88
2022-07,8955 - Department of Veterans Affairs,30,23,58,126,91,124,452
2022-07,A059 - California Correctional Health Care Services,2,353,376,540,302,940,2513
2022-07,A314 - California Science Center,2,2,26,0,0,2,32
2022-07,A341 - California Earthquake Authority,1,0,2,3,5,64,75
2022-07,A424 - Cradle-to-Career,0,0,0,4,0,3,7
2022-07,A541 - Board of Forestry and Fire Protection,0,0,1,3,3,3,10
2022-08,0500 - Governor's Office,19,15,29,30,17,22,132
2022-08,0509 - Governor's Office of Business and Economic Development (GO-Biz),1,7,4,12,10,97,131
2022-08,0511 - Secretary for Government Operations Agency,0,0,0,9,6,5,20
2022-08,"0515 - Secretary for Business, Consumer Services, and Housing Agency",2,0,6,5,10,36,59
2022-08,0521 - Secretary for Transportation Agency,0,0,2,15,0,0,17
2022-08,0531 - Office of Systems Integration,6,2,1,7,15,320,351
2022-08,0540 - Secretary of the Natural Resources Agency,1,2,1,10,0,72,86
2022-08,0552 - Office of the Inspector General,9,7,2,5,7,101,131
2022-08,0555 - Secretary for Environmental Protection,0,0,0,0,0,72,72
2022-08,0559 - Secretary for Labor and Workforce Development Agency,4,2,8,8,3,3,28
2022-08,0650 - Office of Planning and Research,1,0,11,22,33,93,160
2022-08,0690 - Governor's Office of Emergency Services,221,153,181,169,159,62,945
2022-08,0820 - Department of Justice,366,321,538,562,586,1708,4081
2022-08,0840 - State Controller,65,35,79,118,148,695,1140
2022-08,0845 - Department of Insurance,2,119,19,28,83,476,727
2022-08,0855 - California Gambling Control Commission,2,0,0,7,8,22,39
2022-08,0860 - State Board of Equalization,1,1,15,116,2,27,162
2022-08,0890 - Secretary of State,17,18,33,364,38,91,561
2022-08,0911 - Citizens Redistricting Commission,0,0,0,2,1,5,8
2022-08,1045 - Cannabis Control Appeals Panel,1,0,2,0,1,4,8
2022-08,1111 - Department of Consumer Affairs,226,266,330,339,442,444,2047
2022-08,1115 - Department of Cannabis Control,0,65,15,42,28,200,350
2022-08,1700 - California Civil Rights Department,6,1,3,20,37,209,276
2022-08,1701 - Department of Financial Protection and Innovation,0,6,34,22,59,559,680
2022-08,1703 - California Privacy Protection Agency,1,0,0,0,0,11,12
2022-08,1750 - California Horse Racing Board,1,4,1,8,2,11,27
2022-08,2100 - Department of Alcoholic Beverage Control,160,102,93,56,27,48,486
2022-08,2120 - Alcoholic Beverage Control Appeals Board,0,0,1,2,1,2,6
2022-08,2240 - Department of Housing and Community Development,90,16,96,98,86,636,1022
2022-08,2320 - Department of Real Estate,3,15,22,104,80,21,245
2022-08,2600 - California Transportation Commission,0,1,2,8,2,23,36
2022-08,2660 - Department of Transportation,126,383,1311,5923,2936,2236,12915
2022-08,2665 - High-Speed Rail Authority,5,28,23,30,58,189,333
2022-08,2700 - California Traffic Safety Program,0,0,0,1,26,1,28
2022-08,2720 - California Highway Patrol,1013,0,321,0,130,0,1464
2022-08,3100 - Exposition Park,0,0,7,0,0,0,7
2022-08,3105 - California African-American Museum,0,18,0,0,0,0,18
2022-08,3125 - California Tahoe Conservancy,6,1,11,6,4,18,46
2022-08,3340 - California Conservation Corps,0,19,25,25,31,43,143
2022-08,3355 - Office of Energy Infrastructure Safety,2,0,0,0,0,51,53
2022-08,3360 - Energy Resources Conservation and Development Commission,1,5,11,24,46,585,672
2022-08,3480 - Department of Conservation,32,10,60,91,56,389,638
2022-08,3540 - Department of Forestry and Fire Protection,5,52,128,141,120,176,622
2022-08,3560 - State Lands Commission,2,6,13,17,26,93,157
2022-08,3600 - Department of Fish and Wildlife,339,61,180,204,254,895,1933
2022-08,3640 - Wildlife Conservation Board,5,0,0,2,1,22,30
2022-08,3720 - California Coastal Commission,2,6,8,40,60,48,164
2022-08,3760 - State Coastal Conservancy,0,0,2,2,15,43,62
2022-08,3780 - Native American Heritage Commission,0,0,1,0,0,7,8
2022-08,3790 - Department of Parks and Recreation,220,42,135,146,183,236,962
2022-08,3810 - Santa Monica Mountains Conservancy,0,0,0,0,0,6,6
2022-08,3820 - San Francisco Bay Conservation and Development Commission,0,0,0,0,0,47,47
2022-08,3825 - San Gabriel and Lower Los Angeles Rivers and Mountains Conservancy,0,0,0,1,8,1,10
2022-08,3830 - San Joaquin River Conservancy,0,0,0,0,1,2,3
2022-08,3835 - Baldwin Hills Conservancy,0,0,0,1,1,1,3
2022-08,3840 - Delta Protection Commission,1,1,0,1,0,3,6
2022-08,3845 - San Diego River Conservancy,3,0,0,0,0,0,3
2022-08,3850 - Coachella Valley Mountains Conservancy,0,2,1,1,0,0,4
2022-08,3855 - Sierra Nevada Conservancy,0,0,8,7,11,19,45
2022-08,3860 - Department of Water Resources,27,107,588,913,367,177,2179
2022-08,3862 - Central Valley Flood Protection Board,0,6,2,7,15,21,51
2022-08,3875 - Sacramento-San Joaquin Delta Conservancy,0,0,1,0,1,11,13
2022-08,3885 - Delta Stewardship Council,0,1,1,6,10,46,64
2022-08,3900 - State Air Resources Board,37,130,207,496,618,196,1684
2022-08,3930 - Department of Pesticide Regulation,1,7,29,93,96,193,419
2022-08,3940 - State Water Resources Control Board,21,41,302,254,589,930,2137
2022-08,3960 - Department of Toxic Substances Control,9,32,98,78,135,608,960
2022-08,3970 - Department of Resources Recycling and Recovery,1,14,23,49,96,433,616
2022-08,3980 - Office of Environmental Health Hazard Assessment,0,0,1,5,20,109,135
2022-08,4100 - State Council on Developmental Disabilities,3,6,5,12,4,30,60
2022-08,4140 - Department of Health Care Access and Information,67,20,115,20,50,191,463
2022-08,4150 - Department of Managed Health Care,0,0,0,12,5,604,621
2022-08,4170 - Department of Aging,3,1,9,10,13,184,220
2022-08,4250 - California Children and Families Commission,0,0,2,36,0,1,39
2022-08,4260 - State Department of Health Care Services,1106,34,117,242,781,1690,3970
2022-08,4265 - Department of Public Health,1126,24,83,112,137,2456,3938
2022-08,4300 - Department of Developmental Services,24,7,34,49,95,375,584
2022-08,4440 - Department of State Hospitals,1,323,165,118,275,340,1222
2022-08,4560 - Mental Health Services Oversight and Accountability Commission,7,3,8,10,15,7,50
2022-08,4700 - Department of Community Services and Development,2,0,2,4,3,112,123
2022-08,4800 - California Health Benefit Exchange,35,12,33,55,68,1197,1400
2022-08,5160 - Department of Rehabilitation,146,134,391,502,231,243,1647
2022-08,5175 - Department of Child Support Services,0,12,12,10,92,444,570
2022-08,5180 - Department of Social Services,0,359,1179,494,403,1566,4001
2022-08,5225 - Department of Corrections and Rehabilitation,1050,491,816,697,404,1908,5366
2022-08,5227 - Board of State and Community Corrections,9,1,1,8,88,11,118
2022-08,5420 - Prison Industry Authority,20,4,48,100,41,6,219
2022-08,6120 - California State Library,3,22,27,16,21,55,144
2022-08,6125 - Education Audit Appeals Panel,0,0,0,1,2,0,3
2022-08,6250 - California School for the Deaf - Riverside,5,0,9,1,2,0,17
2022-08,6360 - Commission on Teacher Credentialing,20,7,12,19,36,65,159
2022-08,6870 - Board of Governors of the California Community Colleges,0,0,1,6,3,167,177
2022-08,"6980 - Student Aid Commission, California",5,1,1,10,21,90,128
2022-08,7100 - Employment Development Department,0,0,419,1617,0,5695,7731
2022-08,7120 - California Workforce Development Board,0,0,0,0,1,74,75
2022-08,7300 - Agricultural Labor Relations Board,5,0,6,32,6,8,57
2022-08,7320 - Public Employment Relations Board,2,3,5,19,26,8,63
2022-08,7501 - Department of Human Resources,8,3,16,64,53,137,281
2022-08,7502 - California Department of Technology,62,6,8,33,47,767,923
2022-08,7503 - State Personnel Board,0,1,0,3,13,55,72
2022-08,7504 - Office of Data and Innovation,0,0,0,0,0,27,27
2022-08,7600 - California Department of Tax and Fee Administration,15,16,106,361,602,2491,3591
2022-08,7730 - Franchise Tax Board,379,130,943,3280,259,188,5179
2022-08,7760 - Department of General Services,386,57,267,193,181,784,1868
2022-08,7870 - California Victim Compensation Board,1,0,12,15,195,1,224
2022-08,7910 - Office of Administrative Law,0,2,6,6,7,2,23
2022-08,7920 - State Teachers' Retirement System,14,8,231,948,36,3,1240
2022-08,8120 - Commission on Peace Officer Standards and Training,5,0,124,0,0,2,131
2022-08,8140 - State Public Defender,11,2,13,11,4,43,84
2022-08,8570 - Department of Food and Agriculture,47,24,28,43,64,104,310
2022-08,8620 - Fair Political Practices Commission,1,0,2,9,16,57,85
2022-08,8660 - Public Utilities Commission,11,9,23,46,59,1151,1299
2022-08,"8780 - Milton Marks ""Little Hoover"" Commission on California State Government Organization and Economy",0,0,0,3,0,3,6
2022-08,8825 - Commission on Asian and Pacific Islander American Affairs,0,0,0,0,0,3,3
2022-08,"8830 - Law Revision Commission, California",0,0,0,0,0,8,8
2022-08,8860 - Department of Finance,10,7,31,274,28,38,388
2022-08,8880 - Financial Information System for California,1,1,4,5,10,268,289
2022-08,"8885 - States Mandates, Commission on",0,0,1,0,2,10,13
2022-08,8940 - Military Department,3,2,24,41,12,6,88
2022-08,8955 - Department of Veterans Affairs,28,22,60,128,92,124,454
2022-08,A059 - California Correctional Health Care Services,3,373,474,533,309,955,2647
2022-08,A314 - California Science Center,2,3,26,0,0,2,33
2022-08,A341 - California Earthquake Authority,1,0,3,2,5,63,74
2022-08,A424 - Cradle-to-Career,0,0,0,4,0,6,10
2022-08,A541 - Board of Forestry and Fire Protection,0,0,1,3,3,3,10
2022-09,0500 - Governor's Office,24,11,29,30,21,20,135
2022-09,0509 - Governor's Office of Business and Economic Development (GO-Biz),0,6,5,15,10,98,134
2022-09,0511 - Secretary for Government Operations Agency,0,0,1,7,10,6,24
2022-09,"0515 - Secretary for Business, Consumer Services, and Housing Agency",2,0,6,5,10,36,59
2022-09,0521 - Secretary for Transportation Agency,0,0,2,15,0,0,17
2022-09,0531 - Office of Systems Integration,5,2,1,7,16,322,353
2022-09,0540 - Secretary of the Natural Resources Agency,1,2,1,10,0,73,87
2022-09,0552 - Office of the Inspector General,9,7,2,5,7,103,133
2022-09,0555 - Secretary for Environmental Protection,0,0,0,0,0,72,72
2022-09,0559 - Secretary for Labor and Workforce Development Agency,4,2,8,8,3,3,28
2022-09,0650 - Office of Planning and Research,1,0,11,22,33,93,160
2022-09,0690 - Governor's Office of Emergency Services,472,170,200,181,223,31,1277
2022-09,0820 - Department of Justice,369,325,557,565,595,1723,4134
2022-09,0840 - State Controller,64,35,78,118,148,694,1137
2022-09,0845 - Department of Insurance,2,119,19,28,83,476,727
2022-09,0855 - California Gambling Control Commission,0,0,0,7,8,24,39
2022-09,0860 - State Board of Equalization,1,1,15,111,2,26,156
2022-09,0890 - Secretary of State,23,21,33,356,38,90,561
2022-09,0911 - Citizens Redistricting Commission,0,0,0,2,1,5,8
2022-09,1045 - Cannabis Control Appeals Panel,1,0,1,0,1,5,8
2022-09,1111 - Department of Consumer Affairs,251,276,393,403,511,567,2401
2022-09,1115 - Department of Cannabis Control,1,65,16,38,34,205,359
2022-09,1700 - California Civil Rights Department,5,1,3,20,36,209,274
2022-09,1701 - Department of Financial Protection and Innovation,0,6,53,21,59,549,688
2022-09,1703 - California Privacy Protection Agency,1,0,0,0,0,17,18
2022-09,1750 - California Horse Racing Board,1,4,1,8,2,10,26
2022-09,2100 - Department of Alcoholic Beverage Control,146,102,93,55,27,62,485
2022-09,2120 - Alcoholic Beverage Control Appeals Board,0,0,1,2,1,2,6
2022-09,2240 - Department of Housing and Community Development,87,15,94,99,91,643,1029
2022-09,2320 - Department of Real Estate,3,15,26,135,114,21,314
2022-09,2600 - California Transportation Commission,0,1,2,8,2,23,36
2022-09,2660 - Department of Transportation,4,374,1314,5974,2946,2901,13513
2022-09,2665 - High-Speed Rail Authority,4,29,23,33,57,182,328
2022-09,2700 - California Traffic Safety Program,0,0,1,1,25,1,28
2022-09,2720 - California Highway Patrol,1013,0,317,0,131,0,1461
2022-09,3105 - California African-American Museum,0,18,0,0,0,0,18
2022-09,3125 - California Tahoe Conservancy,6,1,11,6,4,18,46
2022-09,3340 - California Conservation Corps,0,20,25,25,30,42,142
2022-09,3355 - Office of Energy Infrastructure Safety,1,0,0,0,0,55,56
2022-09,3360 - Energy Resources Conservation and Development Commission,1,5,11,23,48,582,670
2022-09,3480 - Department of Conservation,32,11,59,91,55,392,640
2022-09,3540 - Department of Forestry and Fire Protection,7,52,129,141,120,175,624
2022-09,3560 - State Lands Commission,4,5,15,16,27,93,160
2022-09,3600 - Department of Fish and Wildlife,276,79,260,246,443,642,1946
2022-09,3640 - Wildlife Conservation Board,5,0,0,2,2,21,30
2022-09,3720 - California Coastal Commission,2,6,9,40,62,48,167
2022-09,3760 - State Coastal Conservancy,0,0,2,2,15,43,62
2022-09,3780 - Native American Heritage Commission,0,0,1,0,0,7,8
2022-09,3790 - Department of Parks and Recreation,289,44,140,163,185,239,1060
2022-09,3810 - Santa Monica Mountains Conservancy,0,0,0,0,0,6,6
2022-09,3820 - San Francisco Bay Conservation and Development Commission,0,0,1,0,46,0,47
2022-09,3825 - San Gabriel and Lower Los Angeles Rivers and Mountains Conservancy,0,0,0,1,9,0,10
2022-09,3830 - San Joaquin River Conservancy,0,0,0,0,1,2,3
2022-09,3835 - Baldwin Hills Conservancy,0,0,0,1,1,1,3
2022-09,3840 - Delta Protection Commission,1,0,0,1,0,3,5
2022-09,3845 - San Diego River Conservancy,3,0,0,0,0,0,3
2022-09,3850 - Coachella Valley Mountains Conservancy,0,2,1,1,0,0,4
2022-09,3855 - Sierra Nevada Conservancy,1,0,7,8,12,18,46
2022-09,3860 - Department of Water Resources,29,115,668,982,399,187,2380
2022-09,3862 - Central Valley Flood Protection Board,0,6,1,7,15,21,50
2022-09,3875 - Sacramento-San Joaquin Delta Conservancy,0,0,1,0,2,10,13
2022-09,3885 - Delta Stewardship Council,0,1,1,6,10,46,64
2022-09,3900 - State Air Resources Board,32,113,199,466,614,198,1622
2022-09,3930 - Department of Pesticide Regulation,1,4,29,93,96,195,418
2022-09,3940 - State Water Resources Control Board,56,40,309,260,603,964,2232
2022-09,3960 - Department of Toxic Substances Control,78,31,105,93,139,672,1118
2022-09,3970 - Department of Resources Recycling and Recovery,1,13,25,47,100,435,621
2022-09,3980 - Office of Environmental Health Hazard Assessment,0,0,1,5,20,109,135
2022-09,4100 - State Council on Developmental Disabilities,3,6,5,12,4,30,60
2022-09,4140 - Department of Health Care Access and Information,66,22,110,19,50,193,460
2022-09,4150 - Department of Managed Health Care,0,0,0,12,5,604,621
2022-09,4170 - Department of Aging,1,1,8,12,15,190,227
2022-09,4250 - California Children and Families Commission,0,0,2,36,0,1,39
2022-09,4260 - State Department of Health Care Services,612,44,134,304,963,1937,3994
2022-09,4265 - Department of Public Health,1126,24,83,112,137,2456,3938
2022-09,4300 - Department of Developmental Services,23,10,32,50,95,386,596
2022-09,4440 - Department of State Hospitals,1,314,186,144,256,410,1311
2022-09,4560 - Mental Health Services Oversight and Accountability Commission,7,3,8,10,15,7,50
2022-09,4700 - Department of Community Services and Development,2,0,2,4,3,111,122
2022-09,4800 - California Health Benefit Exchange,30,11,31,54,66,1160,1352
2022-09,5160 - Department of Rehabilitation,130,134,383,506,228,233,1614
2022-09,5175 - Department of Child Support Services,0,14,12,10,91,452,579
2022-09,5180 - Department of Social Services,15,342,1301,472,445,1563,4138
2022-09,5225 - Department of Corrections and Rehabilitation,1250,531,912,835,710,2616,6854
2022-09,5227 - Board of State and Community Corrections,10,1,1,7,87,10,116
2022-09,5420 - Prison Industry Authority,27,2,51,90,46,11,227
2022-09,6120 - California State Library,4,22,27,16,21,56,146
2022-09,6125 - Education Audit Appeals Panel,0,0,0,1,2,0,3
2022-09,6250 - California School for the Deaf - Riverside,6,0,10,0,2,0,18
2022-09,6360 - Commission on Teacher Credentialing,16,7,13,28,71,27,162
2022-09,6870 - Board of Governors of the California Community Colleges,0,0,1,5,3,169,178
2022-09,"6980 - Student Aid Commission, California",5,1,1,10,21,90,128
2022-09,7100 - Employment Development Department,45,237,422,756,680,5225,7365
2022-09,7120 - California Workforce Development Board,0,0,0,0,0,71,71
2022-09,7300 - Agricultural Labor Relations Board,5,0,6,34,6,8,59
2022-09,7320 - Public Employment Relations Board,2,3,5,19,26,8,63
2022-09,7501 - Department of Human Resources,16,8,23,76,54,142,319
2022-09,7502 - California Department of Technology,65,6,8,32,47,774,932
2022-09,7503 - State Personnel Board,1,0,0,2,12,57,72
2022-09,7504 - Office of Data and Innovation,0,0,0,0,0,33,33
2022-09,7600 - California Department of Tax and Fee Administration,17,17,102,360,621,2482,3599
2022-09,7730 - Franchise Tax Board,418,133,923,3262,282,187,5205
2022-09,7760 - Department of General Services,381,57,269,194,186,801,1888
2022-09,7870 - California Victim Compensation Board,1,0,12,15,194,0,222
2022-09,7910 - Office of Administrative Law,0,2,6,6,7,2,23
2022-09,7920 - State Teachers' Retirement System,12,9,229,943,36,3,1232
2022-09,8120 - Commission on Peace Officer Standards and Training,5,0,126,0,0,2,133
2022-09,8140 - State Public Defender,9,1,13,12,4,39,78
2022-09,8570 - Department of Food and Agriculture,51,17,26,45,62,95,296
2022-09,8620 - Fair Political Practices Commission,1,0,2,11,16,61,91
2022-09,8660 - Public Utilities Commission,19,7,24,46,68,1135,1299
2022-09,"8780 - Milton Marks ""Little Hoover"" Commission on California State Government Organization and Economy",0,0,0,1,0,5,6
2022-09,8825 - Commission on Asian and Pacific Islander American Affairs,0,0,0,0,0,3,3
2022-09,"8830 - Law Revision Commission, California",0,0,0,0,0,8,8
2022-09,8860 - Department of Finance,9,6,30,274,28,39,386
2022-09,8880 - Financial Information System for California,0,2,2,5,11,268,288
2022-09,"8885 - States Mandates, Commission on",0,0,1,0,2,9,12
2022-09,8940 - Military Department,3,2,24,41,12,6,88
2022-09,8955 - Department of Veterans Affairs,28,19,65,127,92,126,457
2022-09,A059 - California Correctional Health Care Services,30,312,487,549,328,950,2656
2022-09,A314 - California Science Center,16,24,209,0,0,16,265
2022-09,A341 - California Earthquake Authority,1,0,2,2,4,64,73
2022-09,A424 - Cradle-to-Career,0,0,0,4,0,5,9
2022-09,A541 - Board of Forestry and Fire Protection,0,0,1,3,3,3,10
2022-10,0500 - Governor's Office,25,11,31,32,21,20,140
2022-10,0509 - Governor's Office of Business and Economic Development (GO-Biz),0,6,5,17,10,102,140
2022-10,0511 - Secretary for Government Operations Agency,0,0,1,7,10,6,24
2022-10,"0515 - Secretary for Business, Consumer Services, and Housing Agency",2,1,6,5,10,36,60
2022-10,0521 - Secretary for Transportation Agency,0,0,2,15,0,0,17
2022-10,0531 - Office of Systems Integration,5,2,1,7,15,326,356
2022-10,0540 - Secretary of the Natural Resources Agency,1,2,1,10,0,71,85
2022-10,0552 - Office of the Inspector General,11,4,3,5,7,107,137
2022-10,0555 - Secretary for Environmental Protection,23,2,2,2,6,41,76
2022-10,0559 - Secretary for Labor and Workforce Development Agency,4,2,8,8,3,3,28
2022-10,0650 - Office of Planning and Research,1,0,11,22,36,108,178
2022-10,0690 - Governor's Office of Emergency Services,508,116,225,137,183,247,1416
2022-10,0820 - Department of Justice,388,317,544,683,585,1718,4235
2022-10,0840 - State Controller,63,38,73,118,150,707,1149
2022-10,0845 - Department of Insurance,6,173,36,61,157,589,1022
2022-10,0855 - California Gambling Control Commission,0,0,0,7,8,25,40
2022-10,0860 - State Board of Equalization,1,1,15,113,2,24,156
2022-10,0890 - Secretary of State,23,21,33,356,38,90,561
2022-10,0911 - Citizens Redistricting Commission,0,0,0,2,1,5,8
2022-10,1045 - Cannabis Control Appeals Panel,1,0,1,0,1,5,8
2022-10,1111 - Department of Consumer Affairs,262,289,399,409,519,574,2452
2022-10,1115 - Department of Cannabis Control,0,69,16,37,39,212,373
2022-10,1700 - California Civil Rights Department,6,1,3,19,35,213,277
2022-10,1701 - Department of Financial Protection and Innovation,0,7,58,20,57,548,690
2022-10,1703 - California Privacy Protection Agency,1,0,0,0,0,19,20
2022-10,1750 - California Horse Racing Board,1,4,0,9,2,10,26
2022-10,2100 - Department of Alcoholic Beverage Control,133,108,98,59,27,61,486
2022-10,2120 - Alcoholic Beverage Control Appeals Board,0,0,1,2,1,2,6
2022-10,2240 - Department of Housing and Community Development,88,15,98,96,92,657,1046
2022-10,2320 - Department of Real Estate,3,15,26,124,118,21,307
2022-10,2600 - California Transportation Commission,0,1,2,8,2,23,36
2022-10,2660 - Department of Transportation,105,375,1315,6036,2942,2914,13687
2022-10,2665 - High-Speed Rail Authority,3,29,24,33,60,191,340
2022-10,2700 - California Traffic Safety Program,0,0,1,1,28,1,31
2022-10,2720 - California Highway Patrol,1014,0,303,0,132,0,1449
2022-10,2740 - Department of Motor Vehicles,795,39,185,307,98,398,1822
2022-10,3100 - Exposition Park,0,0,7,0,0,0,7
2022-10,3105 - California African-American Museum,0,16,0,0,0,0,16
2022-10,3125 - California Tahoe Conservancy,6,1,11,6,4,18,46
2022-10,3340 - California Conservation Corps,0,19,26,25,30,42,142
2022-10,3355 - Office of Energy Infrastructure Safety,1,0,0,0,0,61,62
2022-10,3360 - Energy Resources Conservation and Development Commission,1,5,11,23,48,592,680
2022-10,3480 - Department of Conservation,31,12,58,91,54,400,646
2022-10,3540 - Department of Forestry and Fire Protection,6,58,137,153,124,178,656
2022-10,3560 - State Lands Commission,3,5,16,16,27,92,159
2022-10,3600 - Department of Fish and Wildlife,228,97,278,298,922,139,1962
2022-10,3640 - Wildlife Conservation Board,6,0,0,2,2,21,31
2022-10,3720 - California Coastal Commission,2,6,10,40,63,48,169
2022-10,3760 - State Coastal Conservancy,0,0,2,2,15,43,62
2022-10,3780 - Native American Heritage Commission,0,0,1,0,0,7,8
2022-10,3790 - Department of Parks and Recreation,256,49,137,160,180,229,1011
2022-10,3810 - Santa Monica Mountains Conservancy,0,0,0,0,0,6,6
2022-10,3820 - San Francisco Bay Conservation and Development Commission,0,0,1,0,46,0,47
2022-10,3825 - San Gabriel and Lower Los Angeles Rivers and Mountains Conservancy,0,0,0,1,9,0,10
2022-10,3830 - San Joaquin River Conservancy,0,0,0,0,1,2,3
2022-10,3835 - Baldwin Hills Conservancy,0,0,0,1,1,1,3
2022-10,3840 - Delta Protection Commission,1,0,0,1,0,3,5
2022-10,3845 - San Diego River Conservancy,3,0,0,0,0,0,3
2022-10,3850 - Coachella Valley Mountains Conservancy,0,2,1,1,0,0,4
2022-10,3855 - Sierra Nevada Conservancy,0,0,7,9,11,19,46
2022-10,3860 - Department of Water Resources,32,118,652,1034,407,191,2434
2022-10,3862 - Central Valley Flood Protection Board,0,6,1,7,15,21,50
2022-10,3875 - Sacramento-San Joaquin Delta Conservancy,0,0,0,2,10,1,13
2022-10,3885 - Delta Stewardship Council,0,1,1,6,10,45,63
2022-10,3930 - Department of Pesticide Regulation,1,4,30,90,97,194,416
2022-10,3940 - State Water Resources Control Board,85,41,312,272,607,997,2314
2022-10,3960 - Department of Toxic Substances Control,77,33,117,93,138,674,1132
2022-10,3970 - Department of Resources Recycling and Recovery,1,13,24,49,105,430,622
2022-10,3980 - Office of Environmental Health Hazard Assessment,0,0,1,5,20,109,135
2022-10,4100 - State Council on Developmental Disabilities,3,7,5,16,5,30,66
2022-10,4140 - Department of Health Care Access and Information,70,22,109,20,52,195,468
2022-10,4150 - Department of Managed Health Care,0,0,0,12,5,606,623
2022-10,4170 - Department of Aging,1,0,10,17,31,182,241
2022-10,4250 - California Children and Families Commission,0,0,2,36,0,1,39
2022-10,4260 - State Department of Health Care Services,498,41,135,312,1055,1956,3997
2022-10,4265 - Department of Public Health,1126,24,83,112,137,2456,3938
2022-10,4300 - Department of Developmental Services,21,8,36,48,88,396,597
2022-10,4440 - Department of State Hospitals,5,231,142,80,218,354,1030
2022-10,4560 - Mental Health Services Oversight and Accountability Commission,7,3,8,10,15,7,50
2022-10,4700 - Department of Community Services and Development,2,0,2,4,3,111,122
2022-10,4800 - California Health Benefit Exchange,29,9,32,54,65,1170,1359
2022-10,5160 - Department of Rehabilitation,143,131,374,486,225,225,1584
2022-10,5170 - State Independent Living Council,0,0,0,0,0,2,2
2022-10,5175 - Department of Child Support Services,0,13,12,10,91,451,577
2022-10,5180 - Department of Social Services,0,389,1372,477,502,1671,4411
2022-10,5225 - Department of Corrections and Rehabilitation,1249,466,813,725,439,2030,5722
2022-10,5227 - Board of State and Community Corrections,10,1,1,7,87,9,115
2022-10,5420 - Prison Industry Authority,46,2,38,69,32,7,194
2022-10,6120 - California State Library,3,21,27,16,24,57,148
2022-10,6125 - Education Audit Appeals Panel,0,0,0,1,2,0,3
2022-10,6240 - California School for the Deaf - Fremont,0,0,0,0,0,4,4
2022-10,6250 - California School for the Deaf - Riverside,6,3,5,2,2,0,18
2022-10,6360 - Commission on Teacher Credentialing,19,6,13,30,82,23,173
2022-10,6870 - Board of Governors of the California Community Colleges,0,0,1,5,3,168,177
2022-10,"6980 - Student Aid Commission, California",5,1,1,10,21,90,128
2022-10,7100 - Employment Development Department,49,239,427,769,684,5257,7425
2022-10,7120 - California Workforce Development Board,0,0,0,0,0,71,71
2022-10,7300 - Agricultural Labor Relations Board,9,0,6,36,6,8,65
2022-10,7320 - Public Employment Relations Board,2,3,5,19,26,8,63
2022-10,7501 - Department of Human Resources,8,3,10,58,49,137,265
2022-10,7502 - California Department of Technology,68,6,8,32,46,769,929
2022-10,7503 - State Personnel Board,1,0,0,3,13,55,72
2022-10,7504 - Office of Data and Innovation,0,0,0,0,0,33,33
2022-10,7600 - California Department of Tax and Fee Administration,17,18,103,364,625,2473,3600
2022-10,7730 - Franchise Tax Board,409,137,943,3306,265,185,5245
2022-10,7760 - Department of General Services,374,56,280,201,191,819,1921
2022-10,7870 - California Victim Compensation Board,1,0,12,15,196,0,224
2022-10,7910 - Office of Administrative Law,0,2,6,6,7,2,23
2022-10,7920 - State Teachers' Retirement System,0,9,227,943,36,3,1218
2022-10,8120 - Commission on Peace Officer Standards and Training,4,1,130,0,0,2,137
2022-10,8140 - State Public Defender,11,1,13,12,4,43,84
2022-10,8570 - Department of Food and Agriculture,97,39,52,90,115,162,555
2022-10,8620 - Fair Political Practices Commission,1,0,2,10,16,62,91
2022-10,8660 - Public Utilities Commission,23,7,26,43,68,1136,1303
2022-10,"8780 - Milton Marks ""Little Hoover"" Commission on California State Government Organization and Economy",0,0,0,1,0,5,6
2022-10,8825 - Commission on Asian and Pacific Islander American Affairs,0,0,0,0,0,3,3
2022-10,"8830 - Law Revision Commission, California",0,0,0,0,0,8,8
2022-10,8860 - Department of Finance,9,6,29,277,29,39,389
2022-10,8880 - Financial Information System for California,1,1,5,3,10,267,287
2022-10,"8885 - States Mandates, Commission on",0,0,3,0,2,7,12
2022-10,8940 - Military Department,4,4,28,44,12,4,96
2022-10,8955 - Department of Veterans Affairs,31,19,64,127,92,126,459
2022-10,A059 - California Correctional Health Care Services,31,335,485,551,327,944,2673
2022-10,A279 - Unemployment Insurance Appeals Board,147,17,29,29,79,77,378
2022-10,A281 - Employment Training Panel,0,8,7,15,13,27,70
2022-10,A314 - California Science Center,2,3,25,0,0,2,32
2022-10,A341 - California Earthquake Authority,1,0,2,2,4,59,68
2022-10,A424 - Cradle-to-Career,0,0,0,5,0,5,10
2022-10,A541 - Board of Forestry and Fire Protection,0,0,1,3,3,3,10
2022-11,0500 - Governor's Office,26,10,31,32,22,19,140
2022-11,0509 - Governor's Office of Business and Economic Development (GO-Biz),0,6,5,18,12,104,145
2022-11,0511 - Secretary for Government Operations Agency,0,0,1,7,10,6,24
2022-11,"0515 - Secretary for Business, Consumer Services, and Housing Agency",2,2,6,5,10,35,60
2022-11,0521 - Secretary for Transportation Agency,0,0,2,15,0,0,17
2022-11,0531 - Office of Systems Integration,6,2,1,8,15,338,370
2022-11,0540 - Secretary of the Natural Resources Agency,2,2,1,10,0,78,93
2022-11,0552 - Office of the Inspector General,10,5,1,8,7,109,140
2022-11,0555 - Secretary for Environmental Protection,23,2,2,2,6,41,76
2022-11,0559 - Secretary for Labor and Workforce Development Agency,4,2,8,8,3,3,28
2022-11,0690 - Governor's Office of Emergency Services,534,233,201,240,185,16,1409
2022-11,0820 - Department of Justice,363,286,561,673,599,1711,4193
2022-11,0840 - State Controller,61,38,70,121,151,716,1157
2022-11,0845 - Department of Insurance,6,177,38,67,165,593,1046
2022-11,0855 - California Gambling Control Commission,0,0,0,7,8,25,40
2022-11,0860 - State Board of Equalization,1,2,15,113,2,24,157
2022-11,0890 - Secretary of State,17,18,35,364,38,89,561
2022-11,0911 - Citizens Redistricting Commission,0,0,0,2,1,5,8
2022-11,1045 - Cannabis Control Appeals Panel,1,0,1,0,1,5,8
2022-11,1111 - Department of Consumer Affairs,262,303,441,462,555,594,2617
2022-11,1115 - Department of Cannabis Control,0,70,16,40,39,214,379
2022-11,1700 - California Civil Rights Department,5,1,3,19,36,202,266
2022-11,1701 - Department of Financial Protection and Innovation,0,7,58,20,58,550,693
2022-11,1703 - California Privacy Protection Agency,0,0,0,1,0,19,20
2022-11,1750 - California Horse Racing Board,1,4,0,9,2,10,26
2022-11,2100 - Department of Alcoholic Beverage Control,140,110,96,57,26,48,477
2022-11,2120 - Alcoholic Beverage Control Appeals Board,0,0,1,2,1,2,6
2022-11,2240 - Department of Housing and Community Development,85,15,96,92,90,664,1042
2022-11,2320 - Department of Real Estate,3,15,26,124,118,21,307
2022-11,2600 - California Transportation Commission,0,1,2,10,2,23,38
2022-11,2660 - Department of Transportation,105,374,1314,6033,2941,2913,13680
2022-11,2665 - High-Speed Rail Authority,5,28,23,34,61,191,342
2022-11,2700 - California Traffic Safety Program,0,0,1,2,26,2,31
2022-11,2720 - California Highway Patrol,1015,0,299,0,133,0,1447
2022-11,2740 - Department of Motor Vehicles,580,50,215,337,105,436,1723
2022-11,3100 - Exposition Park,0,0,7,0,0,0,7
2022-11,3105 - California African-American Museum,0,16,0,0,0,0,16
2022-11,3125 - California Tahoe Conservancy,6,1,11,6,4,18,46
2022-11,3340 - California Conservation Corps,0,19,27,24,31,42,143
2022-11,3355 - Office of Energy Infrastructure Safety,1,0,0,0,0,61,62
2022-11,3360 - Energy Resources Conservation and Development Commission,1,5,13,23,48,597,687
2022-11,3480 - Department of Conservation,32,12,57,89,53,399,642
2022-11,3540 - Department of Forestry and Fire Protection,6,57,135,148,121,171,638
2022-11,3560 - State Lands Commission,4,5,16,15,27,93,160
2022-11,3600 - Department of Fish and Wildlife,260,95,268,298,924,120,1965
2022-11,3640 - Wildlife Conservation Board,9,0,0,2,2,19,32
2022-11,3720 - California Coastal Commission,2,6,10,41,67,48,174
2022-11,3760 - State Coastal Conservancy,0,0,2,2,16,43,63
2022-11,3780 - Native American Heritage Commission,0,0,1,0,0,7,8
2022-11,3790 - Department of Parks and Recreation,362,34,124,145,164,221,1050
2022-11,3810 - Santa Monica Mountains Conservancy,0,0,0,0,0,6,6
2022-11,3820 - San Francisco Bay Conservation and Development Commission,0,0,1,0,46,0,47
2022-11,3825 - San Gabriel and Lower Los Angeles Rivers and Mountains Conservancy,1,0,0,1,8,0,10
2022-11,3830 - San Joaquin River Conservancy,0,0,0,0,1,2,3
2022-11,3835 - Baldwin Hills Conservancy,0,0,0,1,1,1,3
2022-11,3840 - Delta Protection Commission,1,0,0,2,0,3,6
2022-11,3845 - San Diego River Conservancy,3,0,0,0,0,0,3
2022-11,3850 - Coachella Valley Mountains Conservancy,0,2,1,1,0,0,4
2022-11,3855 - Sierra Nevada Conservancy,0,0,7,8,9,22,46
2022-11,3860 - Department of Water Resources,31,120,678,994,407,189,2419
2022-11,3862 - Central Valley Flood Protection Board,0,6,1,7,15,20,49
2022-11,3875 - Sacramento-San Joaquin Delta Conservancy,0,0,0,2,9,3,14
2022-11,3885 - Delta Stewardship Council,0,1,1,6,10,46,64
2022-11,3930 - Department of Pesticide Regulation,0,4,30,88,100,194,416
2022-11,3940 - State Water Resources Control Board,82,46,311,274,611,1024,2348
2022-11,3960 - Department of Toxic Substances Control,2,2,14,2,4,18,42
2022-11,3970 - Department of Resources Recycling and Recovery,1,13,25,49,105,432,625
2022-11,3980 - Office of Environmental Health Hazard Assessment,0,0,1,5,20,109,135
2022-11,4100 - State Council on Developmental Disabilities,3,7,5,16,5,30,66
2022-11,4140 - Department of Health Care Access and Information,65,24,111,21,55,197,473
2022-11,4150 - Department of Managed Health Care,0,0,0,10,5,609,624
2022-11,4170 - Department of Aging,1,0,9,17,29,189,245
2022-11,4250 - California Children and Families Commission,0,0,1,35,0,1,37
2022-11,4260 - State Department of Health Care Services,493,37,137,302,1067,1992,4028
2022-11,4265 - Department of Public Health,1126,24,83,112,137,2456,3938
2022-11,4300 - Department of Developmental Services,19,10,36,46,97,394,602
2022-11,4440 - Department of State Hospitals,2,334,180,120,240,382,1258
2022-11,4560 - Mental Health Services Oversight and Accountability Commission,7,3,8,10,15,7,50
2022-11,4700 - Department of Community Services and Development,2,0,2,4,3,111,122
2022-11,4800 - California Health Benefit Exchange,30,9,31,54,61,1146,1331
2022-11,5160 - Department of Rehabilitation,164,134,391,490,231,239,1649
2022-11,5170 - State Independent Living Council,0,0,0,0,0,2,2
2022-11,5175 - Department of Child Support Services,1,13,12,10,87,458,581
2022-11,5180 - Department of Social Services,6,406,1403,374,587,1714,4490
2022-11,5225 - Department of Corrections and Rehabilitation,1247,504,855,746,442,2076,5870
2022-11,5227 - Board of State and Community Corrections,11,2,1,6,87,9,116
2022-11,5420 - Prison Industry Authority,3,2,48,90,46,12,201
2022-11,6120 - California State Library,3,21,27,16,24,57,148
2022-11,6125 - Education Audit Appeals Panel,0,0,0,1,2,0,3
2022-11,6240 - California School for the Deaf - Fremont,0,0,0,0,0,4,4
2022-11,6250 - California School for the Deaf - Riverside,6,3,5,2,2,0,18
2022-11,6360 - Commission on Teacher Credentialing,25,5,15,30,83,24,182
2022-11,6870 - Board of Governors of the California Community Colleges,0,0,1,5,2,168,176
2022-11,"6980 - Student Aid Commission, California",5,1,1,10,21,90,128
2022-11,7100 - Employment Development Department,51,239,424,780,694,5254,7442
2022-11,7120 - California Workforce Development Board,0,0,0,0,0,69,69
2022-11,7300 - Agricultural Labor Relations Board,9,0,6,36,6,8,65
2022-11,7320 - Public Employment Relations Board,2,3,5,19,26,8,63
2022-11,7501 - Department of Human Resources,6,3,10,63,48,138,268
2022-11,7502 - California Department of Technology,68,6,7,31,46,775,933
2022-11,7503 - State Personnel Board,1,0,0,2,8,59,70
2022-11,7504 - Office of Data and Innovation,0,0,0,0,0,35,35
2022-11,7600 - California Department of Tax and Fee Administration,17,18,103,364,627,2468,3597
2022-11,7730 - Franchise Tax Board,401,142,949,3288,250,190,5220
2022-11,7760 - Department of General Services,375,57,297,202,201,815,1947
2022-11,7870 - California Victim Compensation Board,1,0,12,15,198,0,226
2022-11,7910 - Office of Administrative Law,0,2,6,6,7,2,23
2022-11,7920 - State Teachers' Retirement System,0,9,224,966,34,3,1236
2022-11,8120 - Commission on Peace Officer Standards and Training,4,1,139,0,0,2,146
2022-11,8140 - State Public Defender,11,1,12,12,4,46,86
2022-11,8570 - Department of Food and Agriculture,100,30,54,97,124,162,567
2022-11,8620 - Fair Political Practices Commission,1,0,2,10,16,62,91
2022-11,8660 - Public Utilities Commission,25,7,25,45,73,1133,1308
2022-11,"8780 - Milton Marks ""Little Hoover"" Commission on California State Government Organization and Economy",0,0,0,1,0,5,6
2022-11,8825 - Commission on Asian and Pacific Islander American Affairs,0,0,0,0,0,3,3
2022-11,"8830 - Law Revision Commission, California",0,0,0,0,0,8,8
2022-11,8860 - Department of Finance,7,5,28,281,29,39,389
2022-11,8880 - Financial Information System for California,0,1,3,7,9,273,293
2022-11,"8885 - States Mandates, Commission on",0,0,3,0,3,6,12
2022-11,8955 - Department of Veterans Affairs,34,19,65,127,91,126,462
2022-11,A059 - California Correctional Health Care Services,2,309,479,547,333,967,2637
2022-11,A279 - Unemployment Insurance Appeals Board,156,18,29,33,76,76,388
2022-11,A281 - Employment Training Panel,0,8,7,15,13,27,70
2022-11,A314 - California Science Center,2,3,25,0,0,2,32
2022-11,A341 - California Earthquake Authority,1,0,2,2,4,59,68
2022-11,A424 - Cradle-to-Career,0,0,0,6,0,4,10
2022-11,A541 - Board of Forestry and Fire Protection,0,0,1,3,3,3,10
2022-12,0500 - Governor's Office,26,11,33,38,17,18,143
2022-12,0509 - Governor's Office of Business and Economic Development (GO-Biz),0,6,5,19,12,102,144
2022-12,0511 - Secretary for Government Operations Agency,0,0,1,9,12,6,28
2022-12,"0515 - Secretary for Business, Consumer Services, and Housing Agency",1,2,6,5,9,38,61
2022-12,0521 - Secretary for Transportation Agency,0,0,2,15,0,0,17
2022-12,0530 - Secretary for California Health and Human Services Agency,0,2,9,6,9,46,72
2022-12,0531 - Office of Systems Integration,6,2,1,9,15,338,371
2022-12,0540 - Secretary of the Natural Resources Agency,1,2,1,10,0,77,91
2022-12,0552 - Office of the Inspector General,9,4,4,6,7,109,139
2022-12,0555 - Secretary for Environmental Protection,23,2,2,3,6,40,76
2022-12,0559 - Secretary for Labor and Workforce Development Agency,4,2,8,8,3,3,28
2022-12,0690 - Governor's Office of Emergency Services,379,200,213,218,251,13,1274
2022-12,0820 - Department of Justice,358,310,566,674,602,1719,4229
2022-12,0840 - State Controller,60,39,70,122,152,724,1167
2022-12,0845 - Department of Insurance,7,173,35,61,175,575,1026
2022-12,0855 - California Gambling Control Commission,0,0,0,8,7,25,40
2022-12,0860 - State Board of Equalization,1,1,15,112,2,24,155
2022-12,0890 - Secretary of State,17,18,36,361,40,91,563
2022-12,0911 - Citizens Redistricting Commission,0,0,0,2,1,4,7
2022-12,1045 - Cannabis Control Appeals Panel,1,0,1,0,1,5,8
2022-12,1111 - Department of Consumer Affairs,261,302,436,453,516,582,2550
2022-12,1115 - Department of Cannabis Control,0,68,22,41,39,218,388
2022-12,1700 - California Civil Rights Department,5,1,3,19,36,202,266
2022-12,1701 - Department of Financial Protection and Innovation,0,6,61,19,59,555,700
2022-12,1703 - California Privacy Protection Agency,0,0,0,1,0,19,20
2022-12,1750 - California Horse Racing Board,1,4,0,9,2,10,26
2022-12,2100 - Department of Alcoholic Beverage Control,135,112,94,57,26,47,471
2022-12,2120 - Alcoholic Beverage Control Appeals Board,0,0,1,2,1,2,6
2022-12,2240 - Department of Housing and Community Development,84,16,95,95,91,672,1053
2022-12,2320 - Department of Real Estate,3,16,27,127,119,21,313
2022-12,2600 - California Transportation Commission,0,1,2,10,2,22,37
2022-12,2660 - Department of Transportation,105,374,1314,6033,2941,2913,13680
2022-12,2665 - High-Speed Rail Authority,7,28,26,38,60,188,347
2022-12,2700 - California Traffic Safety Program,0,0,1,2,26,2,31
2022-12,2720 - California Highway Patrol,1047,0,262,0,135,0,1444
2022-12,2740 - Department of Motor Vehicles,522,58,225,351,109,463,1728
2022-12,3100 - Exposition Park,0,0,7,0,0,0,7
2022-12,3105 - California African-American Museum,0,16,0,0,0,0,16
2022-12,3125 - California Tahoe Conservancy,6,1,11,6,4,18,46
2022-12,3340 - California Conservation Corps,0,16,25,28,31,41,141
2022-12,3355 - Office of Energy Infrastructure Safety,0,0,0,0,0,65,65
2022-12,3360 - Energy Resources Conservation and Development Commission,1,5,12,22,48,596,684
2022-12,3480 - Department of Conservation,32,11,58,91,54,401,647
2022-12,3540 - Department of Forestry and Fire Protection,5,38,116,115,114,165,553
2022-12,3560 - State Lands Commission,6,6,17,15,27,91,162
2022-12,3600 - Department of Fish and Wildlife,282,99,266,292,914,111,1964
2022-12,3640 - Wildlife Conservation Board,9,0,0,2,2,20,33
2022-12,3720 - California Coastal Commission,2,6,10,41,68,48,175
2022-12,3760 - State Coastal Conservancy,0,0,2,2,18,43,65
2022-12,3780 - Native American Heritage Commission,0,0,1,0,0,7,8
2022-12,3790 - Department of Parks and Recreation,552,32,130,156,179,213,1262
2022-12,3810 - Santa Monica Mountains Conservancy,0,0,0,0,0,6,6
2022-12,3820 - San Francisco Bay Conservation and Development Commission,0,0,1,1,45,0,47
2022-12,3825 - San Gabriel and Lower Los Angeles Rivers and Mountains Conservancy,1,0,1,1,7,0,10
2022-12,3830 - San Joaquin River Conservancy,0,0,0,0,1,2,3
2022-12,3835 - Baldwin Hills Conservancy,0,0,0,1,1,1,3
2022-12,3840 - Delta Protection Commission,1,1,0,2,0,3,7
2022-12,3845 - San Diego River Conservancy,3,0,0,0,0,0,3
2022-12,3850 - Coachella Valley Mountains Conservancy,0,2,1,1,0,0,4
2022-12,3855 - Sierra Nevada Conservancy,0,0,7,11,8,21,47
2022-12,3860 - Department of Water Resources,5,129,646,984,407,188,2359
2022-12,3862 - Central Valley Flood Protection Board,0,5,1,2,13,13,34
2022-12,3875 - Sacramento-San Joaquin Delta Conservancy,0,0,0,0,4,11,15
2022-12,3885 - Delta Stewardship Council,0,1,1,6,10,45,63
2022-12,3930 - Department of Pesticide Regulation,1,7,32,84,95,194,413
2022-12,3940 - State Water Resources Control Board,149,47,312,270,598,1023,2399
2022-12,3960 - Department of Toxic Substances Control,81,34,127,98,145,701,1186
2022-12,3970 - Department of Resources Recycling and Recovery,0,8,18,41,89,393,549
2022-12,3980 - Office of Environmental Health Hazard Assessment,0,0,1,5,20,109,135
2022-12,4100 - State Council on Developmental Disabilities,3,7,5,16,5,30,66
2022-12,4140 - Department of Health Care Access and Information,65,24,113,23,55,209,489
2022-12,4150 - Department of Managed Health Care,0,0,0,10,5,609,624
2022-12,4170 - Department of Aging,1,0,8,16,23,192,240
2022-12,4250 - California Children and Families Commission,0,0,1,37,0,1,39
2022-12,4260 - State Department of Health Care Services,426,35,136,305,1094,2025,4021
2022-12,4265 - Department of Public Health,1126,24,83,112,137,2456,3938
2022-12,4300 - Department of Developmental Services,18,10,39,41,99,395,602
2022-12,4440 - Department of State Hospitals,2,358,158,137,222,376,1253
2022-12,4560 - Mental Health Services Oversight and Accountability Commission,7,3,8,10,15,7,50
2022-12,4700 - Department of Community Services and Development,1,0,3,4,3,111,122
2022-12,4800 - California Health Benefit Exchange,21,8,32,52,60,1149,1322
2022-12,5160 - Department of Rehabilitation,158,130,392,480,228,234,1622
2022-12,5170 - State Independent Living Council,0,0,0,0,0,2,2
2022-12,5175 - Department of Child Support Services,0,13,12,10,90,459,584
2022-12,5180 - Department of Social Services,4,396,1392,404,545,1704,4445
2022-12,5225 - Department of Corrections and Rehabilitation,1247,523,881,759,448,2106,5964
2022-12,5227 - Board of State and Community Corrections,11,2,0,6,87,8,114
2022-12,5420 - Prison Industry Authority,38,2,49,91,43,11,234
2022-12,6100 - Department of Education,164,16,19,87,94,901,1281
2022-12,6120 - California State Library,3,22,27,16,23,57,148
2022-12,6125 - Education Audit Appeals Panel,0,0,0,1,2,0,3
2022-12,6240 - California School for the Deaf - Fremont,0,0,0,0,0,4,4
2022-12,6250 - California School for the Deaf - Riverside,6,3,5,2,2,0,18
2022-12,6360 - Commission on Teacher Credentialing,19,8,15,29,83,25,179
2022-12,6870 - Board of Governors of the California Community Colleges,0,0,1,6,2,167,176
2022-12,"6980 - Student Aid Commission, California",5,1,1,10,21,90,128
2022-12,7100 - Employment Development Department,52,249,429,788,698,5240,7456
2022-12,7120 - California Workforce Development Board,0,0,0,0,0,76,76
2022-12,7300 - Agricultural Labor Relations Board,9,0,6,36,6,8,65
2022-12,7320 - Public Employment Relations Board,2,3,5,19,26,8,63
2022-12,7501 - Department of Human Resources,7,3,10,64,50,144,278
2022-12,7502 - California Department of Technology,84,6,7,32,47,794,970
2022-12,7503 - State Personnel Board,1,1,1,2,13,53,71
2022-12,7504 - Office of Data and Innovation,0,0,0,2,0,35,37
2022-12,7600 - California Department of Tax and Fee Administration,15,16,101,364,630,2454,3580
2022-12,7730 - Franchise Tax Board,391,139,927,3284,242,190,5173
2022-12,7760 - Department of General Services,363,56,292,209,208,834,1962
2022-12,7870 - California Victim Compensation Board,1,0,12,15,197,0,225
2022-12,7900 - Public Employees' Retirement System,84,112,1826,14,9,268,2313
2022-12,7910 - Office of Administrative Law,0,2,6,6,7,2,23
2022-12,7920 - State Teachers' Retirement System,0,9,223,983,34,3,1252
2022-12,8120 - Commission on Peace Officer Standards and Training,4,1,142,0,0,2,149
2022-12,8140 - State Public Defender,11,0,11,12,4,46,84
2022-12,8570 - Department of Food and Agriculture,104,37,69,102,139,169,620
2022-12,8620 - Fair Political Practices Commission,1,0,2,10,16,62,91
2022-12,8660 - Public Utilities Commission,25,6,24,44,75,1160,1334
2022-12,"8780 - Milton Marks ""Little Hoover"" Commission on California State Government Organization and Economy",0,0,0,1,0,5,6
2022-12,8825 - Commission on Asian and Pacific Islander American Affairs,0,0,0,0,0,3,3
2022-12,"8830 - Law Revision Commission, California",0,0,0,0,0,8,8
2022-12,8860 - Department of Finance,7,6,28,279,29,40,389
2022-12,8880 - Financial Information System for California,1,2,4,6,12,276,301
2022-12,"8885 - States Mandates, Commission on",0,0,3,0,4,5,12
2022-12,8940 - Military Department,5,4,27,44,12,4,96
2022-12,8955 - Department of Veterans Affairs,38,18,65,128,92,125,466
2022-12,A059 - California Correctional Health Care Services,22,354,473,537,329,958,2673
2022-12,A279 - Unemployment Insurance Appeals Board,160,18,28,33,73,76,388
2022-12,A281 - Employment Training Panel,0,8,7,15,13,27,70
2022-12,A314 - California Science Center,2,3,25,0,0,2,32
2022-12,A341 - California Earthquake Authority,1,0,2,2,4,59,68
2022-12,A424 - Cradle-to-Career,0,0,0,6,0,4,10
2022-12,A541 - Board of Forestry and Fire Protection,0,0,0,2,3,2,7
2023-01,0500 - Governor's Office,25,10,31,41,13,13,133
2023-01,0509 - Governor's Office of Business and Economic Development (GO-Biz),0,6,5,19,12,103,145
2023-01,0511 - Secretary for Government Operations Agency,0,0,2,9,12,0,23
2023-01,"0515 - Secretary for Business, Consumer Services, and Housing Agency",1,2,6,5,8,39,61
2023-01,0521 - Secretary for Transportation Agency,0,0,2,15,0,0,17
2023-01,0530 - Secretary for California Health and Human Services Agency,0,2,10,6,9,46,73
2023-01,0531 - Office of Systems Integration,6,2,1,10,15,337,371
2023-01,0540 - Secretary of the Natural Resources Agency,1,2,2,10,0,74,89
2023-01,0552 - Office of the Inspector General,9,5,2,7,7,111,141
2023-01,0555 - Secretary for Environmental Protection,38,2,2,3,6,41,92
2023-01,0559 - Secretary for Labor and Workforce Development Agency,5,2,11,7,3,4,32
2023-01,0650 - Office of Planning and Research,2,0,11,22,38,123,196
2023-01,0690 - Governor's Office of Emergency Services,358,188,212,197,259,23,1237
2023-01,0820 - Department of Justice,357,288,586,680,616,1711,4238
2023-01,0840 - State Controller,60,39,70,122,152,724,1167
2023-01,0845 - Department of Insurance,6,170,35,61,215,526,1013
2023-01,0855 - California Gambling Control Commission,0,0,0,8,8,27,43
2023-01,0860 - State Board of Equalization,0,1,15,114,4,20,154
2023-01,0911 - Citizens Redistricting Commission,0,0,0,2,1,3,6
2023-01,1045 - Cannabis Control Appeals Panel,1,0,1,0,1,5,8
2023-01,1111 - Department of Consumer Affairs,223,315,442,455,516,586,2537
2023-01,1115 - Department of Cannabis Control,1,64,20,46,44,218,393
2023-01,1700 - California Civil Rights Department,4,1,3,19,35,205,267
2023-01,1701 - Department of Financial Protection and Innovation,1,6,62,16,61,551,697
2023-01,1703 - California Privacy Protection Agency,0,0,0,1,0,19,20
2023-01,1750 - California Horse Racing Board,1,5,0,7,2,11,26
2023-01,2100 - Department of Alcoholic Beverage Control,114,135,90,59,29,49,476
2023-01,2120 - Alcoholic Beverage Control Appeals Board,0,0,1,2,1,2,6
2023-01,2240 - Department of Housing and Community Development,97,17,95,97,93,692,1091
2023-01,2320 - Department of Real Estate,3,16,27,127,119,21,313
2023-01,2600 - California Transportation Commission,0,1,2,10,2,22,37
2023-01,2660 - Department of Transportation,105,374,1314,6033,2941,2913,13680
2023-01,2665 - High-Speed Rail Authority,7,28,26,39,66,182,348
2023-01,2700 - California Traffic Safety Program,0,0,1,2,26,2,31
2023-01,2720 - California Highway Patrol,1142,0,168,0,125,0,1435
2023-01,2740 - Department of Motor Vehicles,475,61,226,369,109,471,1711
2023-01,3100 - Exposition Park,1,0,8,0,0,0,9
2023-01,3105 - California African-American Museum,0,16,0,0,0,0,16
2023-01,3125 - California Tahoe Conservancy,6,1,11,6,4,18,46
2023-01,3340 - California Conservation Corps,0,16,25,29,32,41,143
2023-01,3355 - Office of Energy Infrastructure Safety,1,0,0,0,0,64,65
2023-01,3360 - Energy Resources Conservation and Development Commission,1,5,11,23,46,608,694
2023-01,3480 - Department of Conservation,33,11,52,92,58,396,642
2023-01,3540 - Department of Forestry and Fire Protection,5,49,136,145,134,185,654
2023-01,3560 - State Lands Commission,29,6,15,15,26,90,181
2023-01,3600 - Department of Fish and Wildlife,277,101,271,302,933,84,1968
2023-01,3640 - Wildlife Conservation Board,9,0,2,3,3,18,35
2023-01,3720 - California Coastal Commission,2,6,10,42,68,48,176
2023-01,3760 - State Coastal Conservancy,0,0,2,2,18,43,65
2023-01,3780 - Native American Heritage Commission,0,1,2,4,1,0,8
2023-01,3790 - Department of Parks and Recreation,733,39,132,169,180,197,1450
2023-01,3810 - Santa Monica Mountains Conservancy,0,0,0,0,0,6,6
2023-01,3820 - San Francisco Bay Conservation and Development Commission,0,0,1,1,44,0,46
2023-01,3825 - San Gabriel and Lower Los Angeles Rivers and Mountains Conservancy,0,0,0,1,7,1,9
2023-01,3830 - San Joaquin River Conservancy,0,0,0,0,2,2,4
2023-01,3835 - Baldwin Hills Conservancy,0,0,1,2,1,0,4
2023-01,3840 - Delta Protection Commission,1,1,0,2,0,3,7
2023-01,3845 - San Diego River Conservancy,3,0,0,0,0,0,3
2023-01,3850 - Coachella Valley Mountains Conservancy,0,2,1,1,0,0,4
2023-01,3855 - Sierra Nevada Conservancy,0,0,8,13,9,19,49
2023-01,3860 - Department of Water Resources,5,127,630,982,406,188,2338
2023-01,3862 - Central Valley Flood Protection Board,0,6,1,9,19,20,55
2023-01,3875 - Sacramento-San Joaquin Delta Conservancy,0,0,0,0,3,13,16
2023-01,3885 - Delta Stewardship Council,0,1,1,6,10,44,62
2023-01,3900 - State Air Resources Board,103,271,144,151,855,40,1564
2023-01,3930 - Department of Pesticide Regulation,0,9,31,80,96,195,411
2023-01,3940 - State Water Resources Control Board,101,44,330,260,618,1045,2398
2023-01,3960 - Department of Toxic Substances Control,81,34,136,99,151,707,1208
2023-01,3970 - Department of Resources Recycling and Recovery,0,10,27,38,95,380,550
2023-01,3980 - Office of Environmental Health Hazard Assessment,0,0,1,5,20,109,135
2023-01,4100 - State Council on Developmental Disabilities,3,7,5,16,5,30,66
2023-01,4140 - Department of Health Care Access and Information,69,10,112,30,47,226,494
2023-01,4150 - Department of Managed Health Care,0,0,0,10,5,603,618
2023-01,4170 - Department of Aging,1,0,8,16,22,197,244
2023-01,4250 - California Children and Families Commission,0,0,1,37,0,1,39
2023-01,4260 - State Department of Health Care Services,460,34,129,296,1097,2023,4039
2023-01,4265 - Department of Public Health,1126,24,83,112,137,2456,3938
2023-01,4300 - Department of Developmental Services,19,10,37,43,100,397,606
2023-01,4440 - Department of State Hospitals,43,365,162,119,234,378,1301
2023-01,4560 - Mental Health Services Oversight and Accountability Commission,7,3,8,10,15,7,50
2023-01,4700 - Department of Community Services and Development,1,0,2,4,3,109,119
2023-01,4800 - California Health Benefit Exchange,19,7,30,57,59,1153,1325
2023-01,5160 - Department of Rehabilitation,158,130,398,484,229,235,1634
2023-01,5170 - State Independent Living Council,0,0,0,0,0,2,2
2023-01,5175 - Department of Child Support Services,0,13,12,10,95,456,586
2023-01,5180 - Department of Social Services,9,428,1397,409,620,1638,4501
2023-01,5225 - Department of Corrections and Rehabilitation,1051,497,849,711,410,1981,5499
2023-01,5227 - Board of State and Community Corrections,11,2,1,6,87,8,115
2023-01,5420 - Prison Industry Authority,19,4,46,93,41,11,214
2023-01,6100 - Department of Education,173,16,20,86,93,905,1293
2023-01,6120 - California State Library,3,22,28,16,23,59,151
2023-01,6125 - Education Audit Appeals Panel,0,0,0,1,2,0,3
2023-01,6240 - California School for the Deaf - Fremont,0,0,0,0,0,4,4
2023-01,6250 - California School for the Deaf - Riverside,5,3,5,2,2,0,17
2023-01,6360 - Commission on Teacher Credentialing,20,8,19,27,84,25,183
2023-01,6870 - Board of Governors of the California Community Colleges,0,0,1,6,2,173,182
2023-01,"6980 - Student Aid Commission, California",5,1,1,10,21,90,128
2023-01,7100 - Employment Development Department,53,253,427,789,703,5204,7429
2023-01,7120 - California Workforce Development Board,0,0,0,0,0,71,71
2023-01,7300 - Agricultural Labor Relations Board,10,0,5,36,6,8,65
2023-01,7320 - Public Employment Relations Board,2,3,5,19,26,8,63
2023-01,7501 - Department of Human Resources,7,3,10,60,48,147,275
2023-01,7502 - California Department of Technology,84,6,7,32,47,782,958
2023-01,7503 - State Personnel Board,2,0,0,2,13,54,71
2023-01,7504 - Office of Data and Innovation,0,0,0,2,0,37,39
2023-01,7600 - California Department of Tax and Fee Administration,18,19,101,375,716,2444,3673
2023-01,7730 - Franchise Tax Board,427,129,908,3324,230,182,5200
2023-01,7760 - Department of General Services,335,55,322,217,227,868,2024
2023-01,7870 - California Victim Compensation Board,2,0,12,15,198,0,227
2023-01,7900 - Public Employees' Retirement System,84,35,1898,14,9,268,2308
2023-01,7910 - Office of Administrative Law,0,2,6,6,7,2,23
2023-01,7920 - State Teachers' Retirement System,0,8,217,977,37,3,1242
2023-01,8120 - Commission on Peace Officer Standards and Training,3,2,138,0,0,11,154
2023-01,8140 - State Public Defender,12,1,10,13,5,48,89
2023-01,8570 - Department of Food and Agriculture,96,36,58,91,129,154,564
2023-01,8620 - Fair Political Practices Commission,1,0,2,11,17,60,91
2023-01,8660 - Public Utilities Commission,2,14,35,56,80,1128,1315
2023-01,"8780 - Milton Marks ""Little Hoover"" Commission on California State Government Organization and Economy",0,0,0,1,0,4,5
2023-01,"8830 - Law Revision Commission, California",0,0,0,0,0,8,8
2023-01,8860 - Department of Finance,7,7,27,279,28,39,387
2023-01,8880 - Financial Information System for California,1,0,3,6,20,273,303
2023-01,"8885 - States Mandates, Commission on",0,0,3,0,2,10,15
2023-01,8940 - Military Department,1,6,27,52,11,4,101
2023-01,8955 - Department of Veterans Affairs,37,18,66,128,92,125,466
2023-01,A059 - California Correctional Health Care Services,2,414,521,534,331,970,2772
2023-01,A279 - Unemployment Insurance Appeals Board,158,19,28,41,69,73,388
2023-01,A281 - Employment Training Panel,0,9,12,10,38,5,74
2023-01,A314 - California Science Center,5,3,22,0,0,3,33
2023-01,A341 - California Earthquake Authority,0,0,2,7,6,50,65
2023-01,A424 - Cradle-to-Career,0,0,0,5,0,4,9
2023-01,A541 - Board of Forestry and Fire Protection,0,0,0,3,4,2,9
2023-02,0500 - Governor's Office,28,10,31,39,13,12,133
2023-02,0509 - Governor's Office of Business and Economic Development (GO-Biz),0,6,5,19,13,102,145
2023-02,0511 - Secretary for Government Operations Agency,0,0,2,9,12,0,23
2023-02,"0515 - Secretary for Business, Consumer Services, and Housing Agency",1,3,6,5,8,42,65
2023-02,0521 - Secretary for Transportation Agency,0,0,3,16,0,0,19
2023-02,0530 - Secretary for California Health and Human Services Agency,0,2,11,6,11,51,81
2023-02,0531 - Office of Systems Integration,6,2,1,10,16,343,378
2023-02,0540 - Secretary of the Natural Resources Agency,1,2,2,10,0,74,89
2023-02,0552 - Office of the Inspector General,7,3,3,7,7,117,144
2023-02,0555 - Secretary for Environmental Protection,34,2,2,3,6,38,85
2023-02,0559 - Secretary for Labor and Workforce Development Agency,5,2,11,7,3,4,32
2023-02,0650 - Office of Planning and Research,2,0,11,22,38,123,196
2023-02,0690 - Governor's Office of Emergency Services,311,179,203,182,263,29,1167
2023-02,0820 - Department of Justice,42,292,581,690,628,1704,3937
2023-02,0840 - State Controller,62,39,71,122,152,726,1172
2023-02,0845 - Department of Insurance,3,175,32,61,214,532,1017
2023-02,0855 - California Gambling Control Commission,0,0,0,8,8,26,42
2023-02,0860 - State Board of Equalization,0,1,15,114,4,19,153
2023-02,0870 - Office of Tax Appeals,2,3,8,39,16,26,94
2023-02,0911 - Citizens Redistricting Commission,0,0,0,1,1,3,5
2023-02,1045 - Cannabis Control Appeals Panel,1,0,1,0,1,5,8
2023-02,1111 - Department of Consumer Affairs,223,315,442,455,516,586,2537
2023-02,1115 - Department of Cannabis Control,0,65,24,47,38,218,392
2023-02,1700 - California Civil Rights Department,4,1,3,19,35,205,267
2023-02,1701 - Department of Financial Protection and Innovation,1,6,62,16,61,551,697
2023-02,1703 - California Privacy Protection Agency,0,0,0,1,0,22,23
2023-02,1750 - California Horse Racing Board,1,5,0,7,2,10,25
2023-02,2100 - Department of Alcoholic Beverage Control,114,134,90,59,29,48,474
2023-02,2120 - Alcoholic Beverage Control Appeals Board,0,0,1,2,1,2,6
2023-02,2240 - Department of Housing and Community Development,94,20,97,94,94,706,1105
2023-02,2320 - Department of Real Estate,6,10,25,115,122,27,305
2023-02,2600 - California Transportation Commission,0,1,2,10,2,22,37
2023-02,2660 - Department of Transportation,105,374,1314,6033,2941,2913,13680
2023-02,2665 - High-Speed Rail Authority,6,28,26,42,63,187,352
2023-02,2700 - California Traffic Safety Program,0,0,1,8,21,2,32
2023-02,2720 - California Highway Patrol,1171,0,141,0,114,0,1426
2023-02,2740 - Department of Motor Vehicles,441,60,243,381,121,506,1752
2023-02,3100 - Exposition Park,1,0,8,0,0,0,9
2023-02,3105 - California African-American Museum,0,16,0,0,0,0,16
2023-02,3125 - California Tahoe Conservancy,6,1,11,6,4,18,46
2023-02,3340 - California Conservation Corps,0,16,24,30,32,40,142
2023-02,3355 - Office of Energy Infrastructure Safety,1,0,0,0,0,64,65
2023-02,3360 - Energy Resources Conservation and Development Commission,0,7,9,25,49,609,699
2023-02,3480 - Department of Conservation,33,11,53,91,58,404,650
2023-02,3540 - Department of Forestry and Fire Protection,6,53,143,148,142,191,683
2023-02,3560 - State Lands Commission,29,6,14,15,26,89,179
2023-02,3600 - Department of Fish and Wildlife,296,102,269,307,942,80,1996
2023-02,3640 - Wildlife Conservation Board,10,0,2,3,3,18,36
2023-02,3720 - California Coastal Commission,2,6,10,42,68,48,176
2023-02,3760 - State Coastal Conservancy,0,0,2,2,18,43,65
2023-02,3780 - Native American Heritage Commission,0,1,2,4,1,0,8
2023-02,3790 - Department of Parks and Recreation,749,35,130,179,186,188,1467
2023-02,3810 - Santa Monica Mountains Conservancy,0,0,0,0,0,6,6
2023-02,3820 - San Francisco Bay Conservation and Development Commission,0,0,1,1,45,0,47
2023-02,3825 - San Gabriel and Lower Los Angeles Rivers and Mountains Conservancy,0,0,0,1,7,1,9
2023-02,3830 - San Joaquin River Conservancy,0,0,0,0,2,2,4
2023-02,3835 - Baldwin Hills Conservancy,0,0,1,2,1,0,4
2023-02,3840 - Delta Protection Commission,2,1,0,2,0,2,7
2023-02,3845 - San Diego River Conservancy,3,0,0,0,0,0,3
2023-02,3850 - Coachella Valley Mountains Conservancy,0,2,1,1,0,0,4
2023-02,3855 - Sierra Nevada Conservancy,0,0,7,14,9,18,48
2023-02,3860 - Department of Water Resources,33,129,640,977,405,187,2371
2023-02,3862 - Central Valley Flood Protection Board,0,6,1,13,22,22,64
2023-02,3875 - Sacramento-San Joaquin Delta Conservancy,0,0,0,1,4,12,17
2023-02,3885 - Delta Stewardship Council,0,1,2,6,10,43,62
2023-02,3900 - State Air Resources Board,133,273,145,149,857,41,1598
2023-02,3930 - Department of Pesticide Regulation,0,9,31,82,98,194,414
2023-02,3940 - State Water Resources Control Board,127,49,347,267,587,1186,2563
2023-02,3960 - Department of Toxic Substances Control,79,34,138,101,155,712,1219
2023-02,3970 - Department of Resources Recycling and Recovery,1,13,20,39,90,399,562
2023-02,3980 - Office of Environmental Health Hazard Assessment,0,0,1,5,20,108,134
2023-02,4100 - State Council on Developmental Disabilities,3,7,5,16,5,29,65
2023-02,4140 - Department of Health Care Access and Information,69,10,113,32,49,230,503
2023-02,4150 - Department of Managed Health Care,0,0,0,6,5,537,548
2023-02,4170 - Department of Aging,1,0,8,15,23,198,245
2023-02,4250 - California Children and Families Commission,0,0,1,37,0,1,39
2023-02,4260 - State Department of Health Care Services,610,31,122,294,1039,1981,4077
2023-02,4265 - Department of Public Health,1126,24,83,112,137,2456,3938
2023-02,4300 - Department of Developmental Services,19,15,40,41,99,404,618
2023-02,4440 - Department of State Hospitals,0,380,182,150,226,386,1324
2023-02,4560 - Mental Health Services Oversight and Accountability Commission,8,3,8,10,15,7,51
2023-02,4700 - Department of Community Services and Development,1,0,2,4,3,109,119
2023-02,4800 - California Health Benefit Exchange,0,4,26,56,62,1157,1305
2023-02,5160 - Department of Rehabilitation,149,133,401,483,228,238,1632
2023-02,5170 - State Independent Living Council,0,0,0,0,0,2,2
2023-02,5175 - Department of Child Support Services,0,13,11,10,91,458,583
2023-02,5180 - Department of Social Services,6,406,1404,374,587,1716,4493
2023-02,5225 - Department of Corrections and Rehabilitation,3164,244,429,304,311,1212,5664
2023-02,5227 - Board of State and Community Corrections,11,2,1,6,86,8,114
2023-02,5420 - Prison Industry Authority,18,4,44,95,42,11,214
2023-02,6100 - Department of Education,187,16,20,85,93,904,1305
2023-02,6120 - California State Library,3,22,28,18,23,58,152
2023-02,6125 - Education Audit Appeals Panel,0,0,0,1,2,0,3
2023-02,6200 - California School for the Blind,17,2,1,2,0,0,22
2023-02,6250 - California School for the Deaf - Riverside,5,3,5,2,2,0,17
2023-02,6260 - Diagnostic Centers,22,1,3,0,0,0,26
2023-02,6360 - Commission on Teacher Credentialing,21,8,21,25,84,23,182
2023-02,6870 - Board of Governors of the California Community Colleges,0,0,1,6,3,174,184
2023-02,"6980 - Student Aid Commission, California",5,1,1,10,21,90,128
2023-02,7100 - Employment Development Department,34,235,391,768,700,5092,7220
2023-02,7120 - California Workforce Development Board,0,0,0,0,0,69,69
2023-02,7300 - Agricultural Labor Relations Board,9,0,5,37,6,8,65
2023-02,7320 - Public Employment Relations Board,2,3,5,19,26,8,63
2023-02,7501 - Department of Human Resources,4,7,10,62,53,146,282
2023-02,7502 - California Department of Technology,87,6,7,32,48,784,964
2023-02,7503 - State Personnel Board,2,0,0,3,13,53,71
2023-02,7504 - Office of Data and Innovation,0,0,0,2,5,36,43
2023-02,7600 - California Department of Tax and Fee Administration,20,13,83,391,718,2423,3648
2023-02,7730 - Franchise Tax Board,464,127,911,3331,218,183,5234
2023-02,7760 - Department of General Services,346,31,318,216,232,895,2038
2023-02,7870 - California Victim Compensation Board,2,0,10,15,199,0,226
2023-02,7900 - Public Employees' Retirement System,84,35,1899,14,10,265,2307
2023-02,7910 - Office of Administrative Law,0,2,6,6,7,2,23
2023-02,7920 - State Teachers' Retirement System,8,9,213,990,35,3,1258
2023-02,8120 - Commission on Peace Officer Standards and Training,5,2,140,0,0,12,159
2023-02,8140 - State Public Defender,12,1,10,13,5,48,89
2023-02,8570 - Department of Food and Agriculture,84,27,49,85,120,150,515
2023-02,8620 - Fair Political Practices Commission,1,0,2,11,17,60,91
2023-02,8660 - Public Utilities Commission,23,6,54,46,87,1102,1318
2023-02,"8780 - Milton Marks ""Little Hoover"" Commission on California State Government Organization and Economy",0,0,0,3,4,0,7
2023-02,"8830 - Law Revision Commission, California",0,0,0,0,0,8,8
2023-02,8860 - Department of Finance,7,7,27,277,28,39,385
2023-02,8880 - Financial Information System for California,1,1,2,10,23,273,310
2023-02,"8885 - States Mandates, Commission on",0,0,3,0,2,10,15
2023-02,8940 - Military Department,1,10,28,52,11,4,106
2023-02,8955 - Department of Veterans Affairs,36,20,63,126,103,125,473
2023-02,A059 - California Correctional Health Care Services,34,552,502,506,325,966,2885
2023-02,A279 - Unemployment Insurance Appeals Board,145,19,29,61,67,73,394
2023-02,A281 - Employment Training Panel,0,9,12,10,38,5,74
2023-02,A314 - California Science Center,6,3,22,0,0,3,34
2023-02,A341 - California Earthquake Authority,0,0,2,7,6,50,65
2023-02,A424 - Cradle-to-Career,0,0,0,6,0,4,10
2023-02,A541 - Board of Forestry and Fire Protection,0,1,0,3,4,2,10
2023-03,0500 - Governor's Office,30,10,28,39,13,12,132
2023-03,0509 - Governor's Office of Business and Economic Development (GO-Biz),1,6,5,19,13,104,148
2023-03,0511 - Secretary for Government Operations Agency,0,0,1,16,8,0,25
2023-03,"0515 - Secretary for Business, Consumer Services, and Housing Agency",1,3,6,5,7,43,65
2023-03,0521 - Secretary for Transportation Agency,0,0,3,16,0,0,19
2023-03,0530 - Secretary for California Health and Human Services Agency,1,2,11,7,12,56,89
2023-03,0531 - Office of Systems Integration,5,2,1,10,16,350,384
2023-03,0540 - Secretary of the Natural Resources Agency,1,2,2,16,0,69,90
2023-03,0552 - Office of the Inspector General,6,3,4,6,7,117,143
2023-03,0555 - Secretary for Environmental Protection,35,2,2,3,6,38,86
2023-03,0559 - Secretary for Labor and Workforce Development Agency,4,5,11,7,3,4,34
2023-03,0650 - Office of Planning and Research,2,0,12,23,39,126,202
2023-03,0690 - Governor's Office of Emergency Services,440,191,191,180,225,30,1257
2023-03,0820 - Department of Justice,466,257,556,682,618,1670,4249
2023-03,0840 - State Controller,54,37,76,140,160,723,1190
2023-03,0845 - Department of Insurance,3,177,31,61,208,534,1014
2023-03,0855 - California Gambling Control Commission,0,0,0,8,8,25,41
2023-03,0860 - State Board of Equalization,0,1,10,125,4,16,156
2023-03,0870 - Office of Tax Appeals,0,3,7,34,21,25,90
2023-03,0911 - Citizens Redistricting Commission,0,0,0,1,1,3,5
2023-03,1045 - Cannabis Control Appeals Panel,1,0,1,0,1,5,8
2023-03,1111 - Department of Consumer Affairs,223,315,442,455,516,586,2537
2023-03,1115 - Department of Cannabis Control,0,69,25,45,39,226,404
2023-03,1700 - California Civil Rights Department,4,1,3,19,35,202,264
2023-03,1701 - Department of Financial Protection and Innovation,0,6,62,18,63,557,706
2023-03,1703 - California Privacy Protection Agency,0,0,0,1,0,21,22
2023-03,1750 - California Horse Racing Board,1,5,0,8,2,10,26
2023-03,2100 - Department of Alcoholic Beverage Control,103,139,92,57,31,52,474
2023-03,2120 - Alcoholic Beverage Control Appeals Board,0,0,1,2,1,2,6
2023-03,2240 - Department of Housing and Community Development,87,23,92,86,91,734,1113
2023-03,2320 - Department of Real Estate,7,11,25,115,121,26,305
2023-03,2600 - California Transportation Commission,0,1,2,10,2,22,37
2023-03,2660 - Department of Transportation,17,491,1255,7070,2307,2307,13447
2023-03,2665 - High-Speed Rail Authority,7,27,26,41,65,192,358
2023-03,2700 - California Traffic Safety Program,0,0,1,9,21,2,33
2023-03,2720 - California Highway Patrol,1081,0,224,0,126,0,1431
2023-03,2740 - Department of Motor Vehicles,381,61,258,408,126,506,1740
2023-03,3100 - Exposition Park,1,0,7,0,0,1,9
2023-03,3105 - California African-American Museum,0,16,0,0,0,0,16
2023-03,3125 - California Tahoe Conservancy,6,1,11,6,4,18,46
2023-03,3340 - California Conservation Corps,0,15,25,34,29,41,144
2023-03,3355 - Office of Energy Infrastructure Safety,0,0,0,0,0,71,71
2023-03,3360 - Energy Resources Conservation and Development Commission,0,7,9,25,49,611,701
2023-03,3480 - Department of Conservation,35,11,54,94,59,408,661
2023-03,3540 - Department of Forestry and Fire Protection,4,56,146,151,146,194,697
2023-03,3560 - State Lands Commission,30,6,13,15,24,90,178
2023-03,3600 - Department of Fish and Wildlife,319,100,269,301,953,69,2011
2023-03,3640 - Wildlife Conservation Board,8,0,2,3,4,19,36
2023-03,3720 - California Coastal Commission,2,6,10,43,69,48,178
2023-03,3760 - State Coastal Conservancy,0,0,2,2,18,43,65
2023-03,3780 - Native American Heritage Commission,0,1,2,4,1,0,8
2023-03,3790 - Department of Parks and Recreation,718,34,134,176,184,180,1426
2023-03,3810 - Santa Monica Mountains Conservancy,0,0,0,0,0,6,6
2023-03,3820 - San Francisco Bay Conservation and Development Commission,0,0,1,2,46,0,49
2023-03,3825 - San Gabriel and Lower Los Angeles Rivers and Mountains Conservancy,0,0,0,1,7,1,9
2023-03,3830 - San Joaquin River Conservancy,0,0,0,0,2,2,4
2023-03,3835 - Baldwin Hills Conservancy,0,0,1,2,1,0,4
2023-03,3840 - Delta Protection Commission,2,1,0,2,0,2,7
2023-03,3845 - San Diego River Conservancy,3,0,0,0,0,0,3
2023-03,3850 - Coachella Valley Mountains Conservancy,0,2,1,1,0,0,4
2023-03,3855 - Sierra Nevada Conservancy,0,1,5,16,7,20,49
2023-03,3860 - Department of Water Resources,34,134,652,1020,401,192,2433
2023-03,3862 - Central Valley Flood Protection Board,0,6,1,9,19,20,55
2023-03,3875 - Sacramento-San Joaquin Delta Conservancy,0,0,0,0,6,11,17
2023-03,3885 - Delta Stewardship Council,0,1,3,6,10,41,61
2023-03,3900 - State Air Resources Board,135,269,143,149,850,41,1587
2023-03,3930 - Department of Pesticide Regulation,1,9,31,83,98,195,417
2023-03,3940 - State Water Resources Control Board,161,43,323,248,601,1015,2391
2023-03,3960 - Department of Toxic Substances Control,73,31,135,94,141,664,1138
2023-03,3970 - Department of Resources Recycling and Recovery,1,12,22,36,95,401,567
2023-03,3980 - Office of Environmental Health Hazard Assessment,0,0,1,5,20,108,134
2023-03,4100 - State Council on Developmental Disabilities,3,7,5,16,5,29,65
2023-03,4140 - Department of Health Care Access and Information,69,9,112,33,46,246,515
2023-03,4150 - Department of Managed Health Care,0,0,0,6,5,537,548
2023-03,4170 - Department of Aging,1,0,8,16,25,199,249
2023-03,4250 - California Children and Families Commission,0,0,0,35,0,1,36
2023-03,4260 - State Department of Health Care Services,704,27,153,246,1467,1492,4089
2023-03,4265 - Department of Public Health,1126,24,83,112,137,2456,3938
2023-03,4300 - Department of Developmental Services,6,11,40,48,100,420,625
2023-03,4440 - Department of State Hospitals,0,380,182,150,226,386,1324
2023-03,4560 - Mental Health Services Oversight and Accountability Commission,8,3,7,10,14,7,49
2023-03,4700 - Department of Community Services and Development,1,0,2,4,3,108,118
2023-03,4800 - California Health Benefit Exchange,19,4,28,52,63,1145,1311
2023-03,5160 - Department of Rehabilitation,148,135,413,490,231,238,1655
2023-03,5170 - State Independent Living Council,0,0,0,0,0,2,2
2023-03,5175 - Department of Child Support Services,0,13,12,9,94,460,588
2023-03,5180 - Department of Social Services,5,401,1400,363,590,1710,4469
2023-03,5225 - Department of Corrections and Rehabilitation,927,427,688,544,395,1648,4629
2023-03,5227 - Board of State and Community Corrections,11,2,1,6,86,8,114
2023-03,5420 - Prison Industry Authority,17,5,47,93,42,11,215
2023-03,6100 - Department of Education,194,15,22,87,94,921,1333
2023-03,6120 - California State Library,3,22,31,18,17,65,156
2023-03,6125 - Education Audit Appeals Panel,0,0,0,1,2,0,3
2023-03,6200 - California School for the Blind,16,3,1,2,0,0,22
2023-03,6240 - California School for the Deaf - Fremont,0,0,0,0,0,4,4
2023-03,6250 - California School for the Deaf - Riverside,5,3,5,2,2,0,17
2023-03,6260 - Diagnostic Centers,22,1,3,0,0,0,26
2023-03,6360 - Commission on Teacher Credentialing,18,8,24,24,84,24,182
2023-03,6870 - Board of Governors of the California Community Colleges,0,0,1,5,3,176,185
2023-03,"6980 - Student Aid Commission, California",5,1,1,10,21,90,128
2023-03,7100 - Employment Development Department,42,254,396,797,716,5125,7330
2023-03,7120 - California Workforce Development Board,0,0,0,0,0,83,83
2023-03,7300 - Agricultural Labor Relations Board,9,0,4,37,5,6,61
2023-03,7320 - Public Employment Relations Board,2,3,5,18,25,9,62
2023-03,7501 - Department of Human Resources,5,13,10,66,59,141,294
2023-03,7502 - California Department of Technology,77,6,8,32,57,783,963
2023-03,7503 - State Personnel Board,1,0,0,4,15,51,71
2023-03,7504 - Office of Data and Innovation,0,0,0,2,5,36,43
2023-03,7600 - California Department of Tax and Fee Administration,25,13,81,394,734,2410,3657
2023-03,7730 - Franchise Tax Board,429,126,916,3333,212,170,5186
2023-03,7760 - Department of General Services,356,29,317,220,232,895,2049
2023-03,7870 - California Victim Compensation Board,2,0,10,15,199,0,226
2023-03,7900 - Public Employees' Retirement System,86,123,1818,11,8,260,2306
2023-03,7910 - Office of Administrative Law,0,2,7,6,7,2,24
2023-03,7920 - State Teachers' Retirement System,8,11,208,991,36,5,1259
2023-03,8120 - Commission on Peace Officer Standards and Training,3,2,147,0,0,13,165
2023-03,8140 - State Public Defender,7,1,12,15,6,48,89
2023-03,8570 - Department of Food and Agriculture,61,22,49,79,89,113,413
2023-03,8620 - Fair Political Practices Commission,1,0,2,10,17,61,91
2023-03,8660 - Public Utilities Commission,23,6,54,46,87,1096,1312
2023-03,"8780 - Milton Marks ""Little Hoover"" Commission on California State Government Organization and Economy",0,0,0,3,4,0,7
2023-03,8825 - Commission on Asian and Pacific Islander American Affairs,0,0,0,0,0,3,3
2023-03,"8830 - Law Revision Commission, California",0,0,0,0,0,8,8
2023-03,8860 - Department of Finance,7,7,27,275,28,39,383
2023-03,8880 - Financial Information System for California,2,8,0,10,24,277,321
2023-03,"8885 - States Mandates, Commission on",0,0,3,0,2,10,15
2023-03,8940 - Military Department,1,8,29,52,11,4,105
2023-03,8955 - Department of Veterans Affairs,36,21,62,129,103,126,477
2023-03,A059 - California Correctional Health Care Services,32,621,535,535,329,969,3021
2023-03,A279 - Unemployment Insurance Appeals Board,142,21,31,77,59,65,395
2023-03,A281 - Employment Training Panel,0,9,12,10,38,5,74
2023-03,A314 - California Science Center,6,3,22,0,0,3,34
2023-03,A341 - California Earthquake Authority,0,0,2,7,6,50,65
2023-03,A424 - Cradle-to-Career,0,0,0,6,0,6,12
2023-03,A541 - Board of Forestry and Fire Protection,0,1,0,3,3,2,9
2023-04,0500 - Governor's Office,28,9,29,40,12,12,130
2023-04,0509 - Governor's Office of Business and Economic Development (GO-Biz),0,7,4,20,14,105,150
2023-04,0511 - Secretary for Government Operations Agency,0,0,2,16,8,0,26
2023-04,"0515 - Secretary for Business, Consumer Services, and Housing Agency",1,3,6,6,7,47,70
2023-04,0521 - Secretary for Transportation Agency,0,0,3,16,0,0,19
2023-04,0530 - Secretary for California Health and Human Services Agency,1,2,11,7,12,56,89
2023-04,0531 - Office of Systems Integration,5,2,1,9,16,360,393
2023-04,0540 - Secretary of the Natural Resources Agency,1,2,2,16,0,70,91
2023-04,0552 - Office of the Inspector General,6,3,3,7,7,117,143
2023-04,0555 - Secretary for Environmental Protection,33,2,2,3,6,38,84
2023-04,0559 - Secretary for Labor and Workforce Development Agency,5,5,11,7,3,4,35
2023-04,0650 - Office of Planning and Research,2,0,12,24,41,128,207
2023-04,0690 - Governor's Office of Emergency Services,0,75,245,138,83,329,870
2023-04,0820 - Department of Justice,397,335,579,667,620,1715,4313
2023-04,0840 - State Controller,46,39,82,138,162,727,1194
2023-04,0845 - Department of Insurance,3,174,31,61,206,542,1017
2023-04,0855 - California Gambling Control Commission,0,0,0,8,8,26,42
2023-04,0860 - State Board of Equalization,0,1,14,116,5,19,155
2023-04,0870 - Office of Tax Appeals,0,3,7,36,21,25,92
2023-04,0890 - Secretary of State,86,34,51,115,66,139,491
2023-04,0911 - Citizens Redistricting Commission,0,0,0,1,1,3,5
2023-04,1045 - Cannabis Control Appeals Panel,1,0,1,0,1,5,8
2023-04,1111 - Department of Consumer Affairs,223,315,442,455,516,586,2537
2023-04,1115 - Department of Cannabis Control,0,73,24,45,39,228,409
2023-04,1700 - California Civil Rights Department,4,1,3,17,33,192,250
2023-04,1701 - Department of Financial Protection and Innovation,0,7,62,18,64,564,715
2023-04,1703 - California Privacy Protection Agency,0,0,0,1,0,22,23
2023-04,1750 - California Horse Racing Board,1,5,0,7,2,11,26
2023-04,2100 - Department of Alcoholic Beverage Control,101,141,91,57,31,52,473
2023-04,2120 - Alcoholic Beverage Control Appeals Board,0,0,1,3,0,2,6
2023-04,2240 - Department of Housing and Community Development,95,24,76,79,97,734,1105
2023-04,2600 - California Transportation Commission,0,1,2,10,2,22,37
2023-04,2660 - Department of Transportation,17,491,1255,7070,2307,2307,13447
2023-04,2665 - High-Speed Rail Authority,0,25,30,47,57,199,358
2023-04,2700 - California Traffic Safety Program,0,0,1,9,21,2,33
2023-04,2720 - California Highway Patrol,1038,0,259,0,137,0,1434
2023-04,2740 - Department of Motor Vehicles,373,57,260,421,121,504,1736
2023-04,3100 - Exposition Park,0,0,9,0,0,0,9
2023-04,3105 - California African-American Museum,0,16,0,0,0,0,16
2023-04,3125 - California Tahoe Conservancy,6,1,11,6,4,18,46
2023-04,3340 - California Conservation Corps,0,15,28,36,30,40,149
2023-04,3355 - Office of Energy Infrastructure Safety,0,0,0,0,0,79,79
2023-04,3360 - Energy Resources Conservation and Development Commission,0,7,9,28,50,614,708
2023-04,3480 - Department of Conservation,34,11,57,92,59,407,660
2023-04,3540 - Department of Forestry and Fire Protection,4,57,154,150,149,197,711
2023-04,3560 - State Lands Commission,27,6,14,15,24,90,176
2023-04,3600 - Department of Fish and Wildlife,340,99,269,304,945,69,2026
2023-04,3640 - Wildlife Conservation Board,14,0,2,3,4,19,42
2023-04,3720 - California Coastal Commission,2,6,10,43,70,48,179
2023-04,3760 - State Coastal Conservancy,0,0,2,2,19,43,66
2023-04,3780 - Native American Heritage Commission,0,1,2,4,1,0,8
2023-04,3790 - Department of Parks and Recreation,760,55,143,237,223,230,1648
2023-04,3810 - Santa Monica Mountains Conservancy,0,0,0,0,0,6,6
2023-04,3820 - San Francisco Bay Conservation and Development Commission,0,0,1,2,47,0,50
2023-04,3825 - San Gabriel and Lower Los Angeles Rivers and Mountains Conservancy,0,0,0,0,10,0,10
2023-04,3830 - San Joaquin River Conservancy,0,0,0,0,2,2,4
2023-04,3835 - Baldwin Hills Conservancy,0,0,1,2,1,0,4
2023-04,3840 - Delta Protection Commission,2,1,0,2,0,2,7
2023-04,3845 - San Diego River Conservancy,3,0,0,0,0,0,3
2023-04,3850 - Coachella Valley Mountains Conservancy,0,2,1,1,0,0,4
2023-04,3855 - Sierra Nevada Conservancy,0,1,6,14,9,19,49
2023-04,3860 - Department of Water Resources,4,126,597,917,389,150,2183
2023-04,3862 - Central Valley Flood Protection Board,0,6,1,7,16,19,49
2023-04,3875 - Sacramento-San Joaquin Delta Conservancy,0,0,0,2,0,16,18
2023-04,3885 - Delta Stewardship Council,0,1,2,7,10,38,58
2023-04,3900 - State Air Resources Board,130,268,144,148,841,79,1610
2023-04,3930 - Department of Pesticide Regulation,2,8,25,90,102,192,419
2023-04,3940 - State Water Resources Control Board,61,52,329,331,571,1003,2347
2023-04,3960 - Department of Toxic Substances Control,9,25,122,66,137,649,1008
2023-04,3980 - Office of Environmental Health Hazard Assessment,0,0,1,5,20,108,134
2023-04,4100 - State Council on Developmental Disabilities,3,7,5,16,5,29,65
2023-04,4140 - Department of Health Care Access and Information,70,9,112,31,44,256,522
2023-04,4150 - Department of Managed Health Care,0,0,0,6,5,540,551
2023-04,4170 - Department of Aging,1,0,9,16,29,198,253
2023-04,4250 - California Children and Families Commission,0,0,0,34,0,1,35
2023-04,4260 - State Department of Health Care Services,522,30,128,303,1075,2023,4081
2023-04,4265 - Department of Public Health,1126,2,83,112,137,2456,3916
2023-04,4300 - Department of Developmental Services,4,10,41,48,100,431,634
2023-04,4440 - Department of State Hospitals,1,416,179,164,227,405,1392
2023-04,4560 - Mental Health Services Oversight and Accountability Commission,8,3,7,10,14,7,49
2023-04,4700 - Department of Community Services and Development,0,0,2,4,3,108,117
2023-04,4800 - California Health Benefit Exchange,20,1,27,52,66,1143,1309
2023-04,5160 - Department of Rehabilitation,133,134,402,482,227,239,1617
2023-04,5170 - State Independent Living Council,0,0,0,0,0,2,2
2023-04,5175 - Department of Child Support Services,0,12,11,9,97,454,583
2023-04,5180 - Department of Social Services,5,401,1387,362,595,1729,4479
2023-04,5225 - Department of Corrections and Rehabilitation,913,430,686,552,404,1659,4644
2023-04,5227 - Board of State and Community Corrections,11,2,1,6,87,8,115
2023-04,5420 - Prison Industry Authority,19,2,54,88,44,13,220
2023-04,6100 - Department of Education,199,15,22,89,94,915,1334
2023-04,6120 - California State Library,3,22,32,15,17,72,161
2023-04,6125 - Education Audit Appeals Panel,0,0,0,1,2,0,3
2023-04,6200 - California School for the Blind,16,3,1,2,0,0,22
2023-04,6240 - California School for the Deaf - Fremont,0,0,0,0,0,4,4
2023-04,6250 - California School for the Deaf - Riverside,5,3,5,2,2,0,17
2023-04,6260 - Diagnostic Centers,22,1,3,0,0,0,26
2023-04,6360 - Commission on Teacher Credentialing,17,7,28,24,87,24,187
2023-04,6870 - Board of Governors of the California Community Colleges,0,0,1,3,3,177,184
2023-04,"6980 - Student Aid Commission, California",5,1,1,10,21,90,128
2023-04,7100 - Employment Development Department,43,252,401,795,726,5152,7369
2023-04,7120 - California Workforce Development Board,0,0,0,0,0,83,83
2023-04,7300 - Agricultural Labor Relations Board,9,0,4,37,5,5,60
2023-04,7320 - Public Employment Relations Board,2,3,5,19,24,9,62
2023-04,7501 - Department of Human Resources,3,12,13,73,60,125,286
2023-04,7502 - California Department of Technology,68,23,8,46,434,398,977
2023-04,7503 - State Personnel Board,2,0,0,4,12,51,69
2023-04,7504 - Office of Data and Innovation,0,0,0,2,4,37,43
2023-04,7600 - California Department of Tax and Fee Administration,26,28,85,402,731,2363,3635
2023-04,7730 - Franchise Tax Board,434,129,921,3336,209,168,5197
2023-04,7760 - Department of General Services,357,29,321,243,223,889,2062
2023-04,7870 - California Victim Compensation Board,3,0,10,15,198,0,226
2023-04,7900 - Public Employees' Retirement System,77,38,1913,10,4,260,2302
2023-04,7910 - Office of Administrative Law,0,2,7,6,7,2,24
2023-04,7920 - State Teachers' Retirement System,6,9,204,1001,38,6,1264
2023-04,8120 - Commission on Peace Officer Standards and Training,3,2,148,0,0,13,166
2023-04,8140 - State Public Defender,6,1,12,15,6,49,89
2023-04,8570 - Department of Food and Agriculture,23,9,12,11,24,9,88
2023-04,8620 - Fair Political Practices Commission,1,0,2,12,17,61,93
2023-04,8660 - Public Utilities Commission,23,6,54,46,87,1096,1312
2023-04,"8780 - Milton Marks ""Little Hoover"" Commission on California State Government Organization and Economy",0,0,0,3,4,0,7
2023-04,8825 - Commission on Asian and Pacific Islander American Affairs,0,0,0,0,0,3,3
2023-04,"8830 - Law Revision Commission, California",0,0,0,0,0,8,8
2023-04,8860 - Department of Finance,8,6,27,278,28,38,385
2023-04,8880 - Financial Information System for California,0,0,2,15,25,278,320
2023-04,"8885 - States Mandates, Commission on",0,0,3,1,1,9,14
2023-04,8940 - Military Department,1,7,28,55,11,4,106
2023-04,8955 - Department of Veterans Affairs,38,18,60,124,99,128,467
2023-04,A059 - California Correctional Health Care Services,34,623,556,534,329,968,3044
2023-04,A279 - Unemployment Insurance Appeals Board,142,23,28,78,60,66,397
2023-04,A281 - Employment Training Panel,0,9,12,10,38,5,74
2023-04,A314 - California Science Center,6,3,22,0,0,3,34
2023-04,A341 - California Earthquake Authority,0,1,2,8,6,52,69
2023-04,A424 - Cradle-to-Career,0,0,0,6,0,7,13
2023-04,A541 - Board of Forestry and Fire Protection,0,1,0,3,3,2,9
2023-05,0500 - Governor's Office,28,9,32,40,12,13,134
2023-05,0509 - Governor's Office of Business and Economic Development (GO-Biz),0,7,5,19,16,103,150
2023-05,0511 - Secretary for Government Operations Agency,0,0,1,19,7,0,27
2023-05,0521 - Secretary for Transportation Agency,0,0,3,16,0,0,19
2023-05,0530 - Secretary for California Health and Human Services Agency,1,2,10,7,12,59,91
2023-05,0531 - Office of Systems Integration,5,2,1,9,17,355,389
2023-05,0540 - Secretary of the Natural Resources Agency,1,2,2,16,0,69,90
2023-05,0552 - Office of the Inspector General,6,4,1,7,7,118,143
2023-05,0555 - Secretary for Environmental Protection,33,2,2,3,6,39,85
2023-05,0559 - Secretary for Labor and Workforce Development Agency,5,6,11,7,3,4,36
2023-05,0650 - Office of Planning and Research,2,0,13,25,40,129,209
2023-05,0690 - Governor's Office of Emergency Services,0,65,270,131,71,292,829
2023-05,0820 - Department of Justice,360,339,566,668,609,1684,4226
2023-05,0840 - State Controller,52,35,80,135,162,730,1194
2023-05,0845 - Department of Insurance,5,166,26,64,212,548,1021
2023-05,0855 - California Gambling Control Commission,0,0,0,8,8,26,42
2023-05,0860 - State Board of Equalization,2,1,10,119,5,19,156
2023-05,0870 - Office of Tax Appeals,0,3,7,37,21,25,93
2023-05,0911 - Citizens Redistricting Commission,0,0,0,1,1,3,5
2023-05,1045 - Cannabis Control Appeals Panel,1,0,1,0,1,5,8
2023-05,1111 - Department of Consumer Affairs,220,313,492,409,571,528,2533
2023-05,1115 - Department of Cannabis Control,0,81,20,45,38,225,409
2023-05,1700 - California Civil Rights Department,4,1,3,19,35,202,264
2023-05,1701 - Department of Financial Protection and Innovation,0,7,61,19,66,565,718
2023-05,1703 - California Privacy Protection Agency,0,0,0,1,0,23,24
2023-05,1750 - California Horse Racing Board,1,5,0,7,2,11,26
2023-05,2100 - Department of Alcoholic Beverage Control,101,142,90,57,31,52,473
2023-05,2120 - Alcoholic Beverage Control Appeals Board,0,0,1,3,0,2,6
2023-05,2240 - Department of Housing and Community Development,100,25,64,84,98,742,1113
2023-05,2320 - Department of Real Estate,22,19,27,130,108,28,334
2023-05,2600 - California Transportation Commission,0,1,2,10,2,22,37
2023-05,2660 - Department of Transportation,17,491,1255,7070,2305,2307,13445
2023-05,2665 - High-Speed Rail Authority,2,24,32,46,60,197,361
2023-05,2700 - California Traffic Safety Program,0,0,1,9,21,2,33
2023-05,2720 - California Highway Patrol,1034,0,266,0,135,0,1435
2023-05,2740 - Department of Motor Vehicles,393,57,259,423,117,500,1749
2023-05,3100 - Exposition Park,0,0,4,4,0,1,9
2023-05,3105 - California African-American Museum,0,16,0,0,0,0,16
2023-05,3125 - California Tahoe Conservancy,6,1,11,6,4,18,46
2023-05,3340 - California Conservation Corps,4,14,28,36,28,40,150
2023-05,3355 - Office of Energy Infrastructure Safety,0,0,0,0,0,79,79
2023-05,3360 - Energy Resources Conservation and Development Commission,0,7,8,29,50,624,718
2023-05,3480 - Department of Conservation,34,11,60,90,61,403,659
2023-05,3540 - Department of Forestry and Fire Protection,4,69,154,154,151,198,730
2023-05,3560 - State Lands Commission,28,6,13,14,25,90,176
2023-05,3600 - Department of Fish and Wildlife,367,104,282,306,926,63,2048
2023-05,3640 - Wildlife Conservation Board,14,0,2,4,5,18,43
2023-05,3720 - California Coastal Commission,2,6,10,43,73,48,182
2023-05,3760 - State Coastal Conservancy,0,0,2,2,19,43,66
2023-05,3780 - Native American Heritage Commission,0,1,2,4,1,0,8
2023-05,3790 - Department of Parks and Recreation,776,56,147,236,224,227,1666
2023-05,3810 - Santa Monica Mountains Conservancy,0,0,0,0,0,6,6
2023-05,3820 - San Francisco Bay Conservation and Development Commission,0,0,1,2,49,0,52
2023-05,3825 - San Gabriel and Lower Los Angeles Rivers and Mountains Conservancy,0,0,0,0,10,0,10
2023-05,3830 - San Joaquin River Conservancy,0,0,0,0,1,1,2
2023-05,3835 - Baldwin Hills Conservancy,0,0,1,2,1,0,4
2023-05,3840 - Delta Protection Commission,2,1,0,2,1,2,8
2023-05,3845 - San Diego River Conservancy,3,0,0,0,0,0,3
2023-05,3850 - Coachella Valley Mountains Conservancy,0,2,1,1,0,0,4
2023-05,3855 - Sierra Nevada Conservancy,0,2,5,14,10,18,49
2023-05,3860 - Department of Water Resources,5,128,615,1042,392,145,2327
2023-05,3862 - Central Valley Flood Protection Board,0,6,1,7,16,19,49
2023-05,3875 - Sacramento-San Joaquin Delta Conservancy,0,0,0,1,10,7,18
2023-05,3885 - Delta Stewardship Council,0,1,3,6,10,38,58
2023-05,3900 - State Air Resources Board,155,264,143,148,845,84,1639
2023-05,3930 - Department of Pesticide Regulation,1,7,26,91,103,194,422
2023-05,3940 - State Water Resources Control Board,62,51,323,334,566,1003,2339
2023-05,3960 - Department of Toxic Substances Control,9,25,120,65,139,663,1021
2023-05,3980 - Office of Environmental Health Hazard Assessment,0,0,1,5,20,108,134
2023-05,4100 - State Council on Developmental Disabilities,3,7,5,16,5,29,65
2023-05,4140 - Department of Health Care Access and Information,74,10,110,31,40,265,530
2023-05,4170 - Department of Aging,1,0,9,18,31,198,257
2023-05,4250 - California Children and Families Commission,0,0,0,32,0,1,33
2023-05,4260 - State Department of Health Care Services,478,35,133,312,1116,2101,4175
2023-05,4265 - Department of Public Health,1126,2,83,112,137,2456,3916
2023-05,4300 - Department of Developmental Services,5,12,37,50,99,435,638
2023-05,4440 - Department of State Hospitals,32,412,180,144,224,417,1409
2023-05,4560 - Mental Health Services Oversight and Accountability Commission,6,3,8,12,13,7,49
2023-05,4700 - Department of Community Services and Development,0,0,2,7,3,108,120
2023-05,4800 - California Health Benefit Exchange,21,1,26,50,55,1165,1318
2023-05,5160 - Department of Rehabilitation,133,139,412,493,229,244,1650
2023-05,5170 - State Independent Living Council,0,0,0,0,0,3,3
2023-05,5175 - Department of Child Support Services,0,12,11,10,97,458,588
2023-05,5180 - Department of Social Services,5,403,1388,364,602,1751,4513
2023-05,5225 - Department of Corrections and Rehabilitation,908,436,702,555,402,1657,4660
2023-05,5227 - Board of State and Community Corrections,11,2,1,7,87,8,116
2023-05,5420 - Prison Industry Authority,24,5,96,65,31,14,235
2023-05,6100 - Department of Education,198,15,23,91,97,929,1353
2023-05,6120 - California State Library,3,22,31,15,18,73,162
2023-05,6125 - Education Audit Appeals Panel,0,0,0,1,2,0,3
2023-05,6200 - California School for the Blind,16,3,1,2,0,0,22
2023-05,6240 - California School for the Deaf - Fremont,0,0,0,0,0,4,4
2023-05,6250 - California School for the Deaf - Riverside,5,3,5,2,2,0,17
2023-05,6260 - Diagnostic Centers,22,1,3,0,0,0,26
2023-05,6360 - Commission on Teacher Credentialing,21,10,24,27,88,23,193
2023-05,"6980 - Student Aid Commission, California",1,2,1,10,21,100,135
2023-05,7100 - Employment Development Department,41,252,401,800,737,5202,7433
2023-05,7120 - California Workforce Development Board,0,0,0,0,0,88,88
2023-05,7300 - Agricultural Labor Relations Board,8,0,4,35,5,5,57
2023-05,7320 - Public Employment Relations Board,2,3,5,19,24,9,62
2023-05,7501 - Department of Human Resources,3,10,18,77,55,147,310
2023-05,7502 - California Department of Technology,65,30,9,47,477,352,980
2023-05,7503 - State Personnel Board,1,0,1,2,12,53,69
2023-05,7504 - Office of Data and Innovation,0,0,0,2,4,38,44
2023-05,7600 - California Department of Tax and Fee Administration,25,27,82,468,1456,1580,3638
2023-05,7730 - Franchise Tax Board,438,128,911,3348,208,164,5197
2023-05,7760 - Department of General Services,357,29,315,256,230,885,2072
2023-05,7870 - California Victim Compensation Board,2,0,11,14,197,0,224
2023-05,7900 - Public Employees' Retirement System,85,29,1908,10,4,270,2306
2023-05,7910 - Office of Administrative Law,0,2,7,6,7,2,24
2023-05,7920 - State Teachers' Retirement System,5,9,200,1015,35,4,1268
2023-05,8120 - Commission on Peace Officer Standards and Training,10,2,150,0,0,13,175
2023-05,8140 - State Public Defender,6,1,12,15,6,49,89
2023-05,8570 - Department of Food and Agriculture,89,37,60,79,115,148,528
2023-05,8620 - Fair Political Practices Commission,1,0,2,12,17,61,93
2023-05,8660 - Public Utilities Commission,1,3,67,56,86,1099,1312
2023-05,"8780 - Milton Marks ""Little Hoover"" Commission on California State Government Organization and Economy",0,0,0,3,4,0,7
2023-05,"8830 - Law Revision Commission, California",0,0,0,0,0,8,8
2023-05,8860 - Department of Finance,7,6,30,276,28,38,385
2023-05,8880 - Financial Information System for California,0,0,1,7,18,290,316
2023-05,"8885 - States Mandates, Commission on",0,0,3,1,1,9,14
2023-05,8940 - Military Department,0,7,27,57,11,4,106
2023-05,8955 - Department of Veterans Affairs,38,19,60,124,97,125,463
2023-05,A059 - California Correctional Health Care Services,37,665,533,529,333,980,3077
2023-05,A279 - Unemployment Insurance Appeals Board,148,23,25,78,61,63,398
2023-05,A281 - Employment Training Panel,0,9,12,10,38,5,74
2023-05,A314 - California Science Center,7,3,21,0,0,3,34
2023-05,A341 - California Earthquake Authority,0,1,2,8,6,53,70
2023-05,A424 - Cradle-to-Career,0,0,0,5,0,8,13
2023-05,A541 - Board of Forestry and Fire Protection,0,1,0,3,4,2,10
2023-06,0500 - Governor's Office,28,9,33,42,12,13,137
2023-06,0509 - Governor's Office of Business and Economic Development (GO-Biz),2,3,11,17,15,106,154
2023-06,0511 - Secretary for Government Operations Agency,0,0,1,26,0,0,27
2023-06,0521 - Secretary for Transportation Agency,0,0,3,16,0,0,19
2023-06,0530 - Secretary for California Health and Human Services Agency,1,2,10,6,11,62,92
2023-06,0531 - Office of Systems Integration,6,2,1,9,17,355,390
2023-06,0540 - Secretary of the Natural Resources Agency,1,2,2,17,0,73,95
2023-06,0552 - Office of the Inspector General,5,4,2,7,7,118,143
2023-06,0555 - Secretary for Environmental Protection,34,2,2,3,6,40,87
2023-06,0559 - Secretary for Labor and Workforce Development Agency,5,6,11,7,3,4,36
2023-06,0650 - Office of Planning and Research,2,0,15,25,41,132,215
2023-06,0690 - Governor's Office of Emergency Services,0,80,300,131,83,328,922
2023-06,0820 - Department of Justice,360,339,566,668,609,1684,4226
2023-06,0840 - State Controller,44,38,82,140,159,736,1199
2023-06,0845 - Department of Insurance,4,175,34,60,203,543,1019
2023-06,0855 - California Gambling Control Commission,0,0,0,8,8,25,41
2023-06,0860 - State Board of Equalization,2,1,10,121,6,19,159
2023-06,0870 - Office of Tax Appeals,0,4,7,42,16,25,94
2023-06,0890 - Secretary of State,87,39,53,120,82,137,518
2023-06,0911 - Citizens Redistricting Commission,0,0,0,1,1,3,5
2023-06,1045 - Cannabis Control Appeals Panel,1,0,1,0,1,5,8
2023-06,1111 - Department of Consumer Affairs,222,318,491,411,573,531,2546
2023-06,1115 - Department of Cannabis Control,0,83,17,49,43,226,418
2023-06,1700 - California Civil Rights Department,4,1,3,19,38,207,272
2023-06,1701 - Department of Financial Protection and Innovation,0,8,64,20,64,576,732
2023-06,1703 - California Privacy Protection Agency,0,0,0,1,0,23,24
2023-06,1750 - California Horse Racing Board,1,5,0,7,2,11,26
2023-06,2100 - Department of Alcoholic Beverage Control,97,144,91,56,31,54,473
2023-06,2120 - Alcoholic Beverage Control Appeals Board,0,0,1,3,0,2,6
2023-06,2240 - Department of Housing and Community Development,97,25,66,84,101,736,1109
2023-06,2320 - Department of Real Estate,9,21,29,133,106,26,324
2023-06,2600 - California Transportation Commission,0,1,1,6,4,26,38
2023-06,2660 - Department of Transportation,17,491,1255,7070,2304,2307,13444
2023-06,2665 - High-Speed Rail Authority,2,25,36,49,58,191,361
2023-06,2700 - California Traffic Safety Program,0,0,1,9,21,2,33
2023-06,2720 - California Highway Patrol,1035,0,316,15,66,0,1432
2023-06,2740 - Department of Motor Vehicles,391,57,260,424,132,511,1775
2023-06,3100 - Exposition Park,0,0,4,4,0,1,9
2023-06,3125 - California Tahoe Conservancy,6,1,11,6,4,18,46
2023-06,3340 - California Conservation Corps,4,13,29,36,30,40,152
2023-06,3355 - Office of Energy Infrastructure Safety,0,0,0,0,0,76,76
2023-06,3360 - Energy Resources Conservation and Development Commission,0,7,9,30,50,628,724
2023-06,3480 - Department of Conservation,32,12,60,90,65,412,671
2023-06,3540 - Department of Forestry and Fire Protection,4,67,158,156,149,203,737
2023-06,3560 - State Lands Commission,28,6,13,15,26,91,179
2023-06,3600 - Department of Fish and Wildlife,406,104,285,311,899,57,2062
2023-06,3640 - Wildlife Conservation Board,11,0,2,7,5,18,43
2023-06,3720 - California Coastal Commission,2,7,10,43,74,48,184
2023-06,3760 - State Coastal Conservancy,0,0,2,2,19,43,66
2023-06,3780 - Native American Heritage Commission,0,1,2,4,1,0,8
2023-06,3790 - Department of Parks and Recreation,779,55,148,240,226,228,1676
2023-06,3810 - Santa Monica Mountains Conservancy,0,0,0,3,0,3,6
2023-06,3820 - San Francisco Bay Conservation and Development Commission,0,0,1,2,48,0,51
2023-06,3825 - San Gabriel and Lower Los Angeles Rivers and Mountains Conservancy,0,1,0,1,7,0,9
2023-06,3830 - San Joaquin River Conservancy,0,0,0,0,1,1,2
2023-06,3835 - Baldwin Hills Conservancy,0,0,1,2,1,0,4
2023-06,3840 - Delta Protection Commission,2,1,0,2,1,2,8
2023-06,3845 - San Diego River Conservancy,3,0,0,0,0,0,3
2023-06,3850 - Coachella Valley Mountains Conservancy,0,1,1,1,0,0,3
2023-06,3855 - Sierra Nevada Conservancy,0,2,5,15,10,18,50
2023-06,3860 - Department of Water Resources,4,120,587,1095,389,138,2333
2023-06,3862 - Central Valley Flood Protection Board,0,6,1,7,16,19,49
2023-06,3875 - Sacramento-San Joaquin Delta Conservancy,0,0,0,3,4,11,18
2023-06,3885 - Delta Stewardship Council,0,1,4,7,10,39,61
2023-06,3900 - State Air Resources Board,162,264,141,148,843,92,1650
2023-06,3930 - Department of Pesticide Regulation,1,8,27,90,102,195,423
2023-06,3940 - State Water Resources Control Board,55,56,334,341,566,996,2348
2023-06,3960 - Department of Toxic Substances Control,9,26,122,67,138,679,1041
2023-06,3980 - Office of Environmental Health Hazard Assessment,0,0,1,5,20,107,133
2023-06,4100 - State Council on Developmental Disabilities,3,7,5,16,5,29,65
2023-06,4140 - Department of Health Care Access and Information,74,9,111,30,41,277,542
2023-06,4150 - Department of Managed Health Care,0,0,0,6,5,543,554
2023-06,4170 - Department of Aging,1,0,8,18,33,200,260
2023-06,4250 - California Children and Families Commission,0,0,0,32,0,1,33
2023-06,4260 - State Department of Health Care Services,722,33,136,281,1066,1983,4221
2023-06,4265 - Department of Public Health,1126,2,83,112,137,2456,3916
2023-06,4300 - Department of Developmental Services,7,12,35,49,98,438,639
2023-06,4440 - Department of State Hospitals,0,616,187,144,253,437,1637
2023-06,4560 - Mental Health Services Oversight and Accountability Commission,5,3,9,14,12,6,49
2023-06,4700 - Department of Community Services and Development,0,0,2,8,10,101,121
2023-06,4800 - California Health Benefit Exchange,20,1,26,50,55,1164,1316
2023-06,5160 - Department of Rehabilitation,137,140,422,499,229,250,1677
2023-06,5170 - State Independent Living Council,0,0,0,0,0,3,3
2023-06,5175 - Department of Child Support Services,1,12,11,10,97,455,586
2023-06,5180 - Department of Social Services,5,400,1373,363,592,1764,4497
2023-06,5225 - Department of Corrections and Rehabilitation,891,442,713,555,408,1662,4671
2023-06,5227 - Board of State and Community Corrections,11,2,1,6,88,9,117
2023-06,5420 - Prison Industry Authority,17,7,117,47,26,18,232
2023-06,6100 - Department of Education,203,16,22,92,96,940,1369
2023-06,6120 - California State Library,3,21,31,15,19,75,164
2023-06,6125 - Education Audit Appeals Panel,0,0,0,1,2,0,3
2023-06,6200 - California School for the Blind,16,3,1,2,0,0,22
2023-06,6240 - California School for the Deaf - Fremont,0,0,0,0,0,4,4
2023-06,6250 - California School for the Deaf - Riverside,5,3,5,2,2,0,17
2023-06,6260 - Diagnostic Centers,22,1,3,0,0,0,26
2023-06,6360 - Commission on Teacher Credentialing,22,7,27,29,90,22,197
2023-06,"6980 - Student Aid Commission, California",1,2,1,10,21,100,135
2023-06,7100 - Employment Development Department,43,251,415,804,743,5227,7483
2023-06,7300 - Agricultural Labor Relations Board,8,0,4,35,5,5,57
2023-06,7320 - Public Employment Relations Board,2,3,5,19,24,9,62
2023-06,7501 - Department of Human Resources,6,10,19,80,60,152,327
2023-06,7502 - California Department of Technology,68,30,8,46,484,339,975
2023-06,7503 - State Personnel Board,2,0,0,4,11,52,69
2023-06,7504 - Office of Data and Innovation,0,0,0,4,4,38,46
2023-06,7600 - California Department of Tax and Fee Administration,21,31,79,475,1468,1568,3642
2023-06,7730 - Franchise Tax Board,472,130,900,3394,206,160,5262
2023-06,7760 - Department of General Services,357,27,328,246,230,897,2085
2023-06,7870 - California Victim Compensation Board,2,0,10,14,197,0,223
2023-06,7900 - Public Employees' Retirement System,76,30,1912,10,4,274,2306
2023-06,7910 - Office of Administrative Law,0,2,7,6,7,2,24
2023-06,7920 - State Teachers' Retirement System,5,9,199,1024,35,3,1275
2023-06,8120 - Commission on Peace Officer Standards and Training,7,2,157,0,0,13,179
2023-06,8140 - State Public Defender,7,1,15,15,6,49,93
2023-06,8570 - Department of Food and Agriculture,65,32,67,89,103,145,501
2023-06,8620 - Fair Political Practices Commission,1,0,2,12,17,60,92
2023-06,8660 - Public Utilities Commission,101,6,72,45,95,1100,1419
2023-06,"8780 - Milton Marks ""Little Hoover"" Commission on California State Government Organization and Economy",0,0,0,3,4,0,7
2023-06,"8830 - Law Revision Commission, California",0,0,0,0,0,8,8
2023-06,8860 - Department of Finance,7,6,30,273,29,39,384
2023-06,8880 - Financial Information System for California,1,0,3,12,18,289,323
2023-06,"8885 - States Mandates, Commission on",0,0,2,1,2,9,14
2023-06,8940 - Military Department,0,7,28,59,11,4,109
2023-06,8955 - Department of Veterans Affairs,36,20,58,130,91,124,459
2023-06,A059 - California Correctional Health Care Services,39,668,553,544,339,974,3117
2023-06,A279 - Unemployment Insurance Appeals Board,154,22,27,77,61,62,403
2023-06,A281 - Employment Training Panel,0,9,12,10,38,5,74
2023-06,A314 - California Science Center,6,4,22,0,0,3,35
2023-06,A341 - California Earthquake Authority,0,1,2,8,6,53,70
2023-06,A424 - Cradle-to-Career,0,0,0,6,0,8,14
2023-06,A541 - Board of Forestry and Fire Protection,0,1,0,3,4,2,10
2023-07,0500 - Governor's Office,29,9,33,42,12,12,137
2023-07,0509 - Governor's Office of Business and Economic Development (GO-Biz),1,3,11,17,15,105,152
2023-07,0511 - Secretary for Government Operations Agency,0,0,13,14,0,0,27
2023-07,0521 - Secretary for Transportation Agency,0,0,3,16,0,1,20
2023-07,0530 - Secretary for California Health and Human Services Agency,1,2,10,6,11,63,93
2023-07,0531 - Office of Systems Integration,5,2,1,9,17,360,394
2023-07,0540 - Secretary of the Natural Resources Agency,1,2,2,19,0,72,96
2023-07,0552 - Office of the Inspector General,6,4,4,8,7,127,156
2023-07,0555 - Secretary for Environmental Protection,34,2,2,3,6,42,89
2023-07,0559 - Secretary for Labor and Workforce Development Agency,5,6,11,7,3,4,36
2023-07,0650 - Office of Planning and Research,2,0,15,25,41,131,214
2023-07,0690 - Governor's Office of Emergency Services,0,86,532,75,52,209,954
2023-07,0820 - Department of Justice,406,335,509,575,565,1649,4039
2023-07,0840 - State Controller,47,37,83,143,159,734,1203
2023-07,0845 - Department of Insurance,5,170,30,63,200,585,1053
2023-07,0855 - California Gambling Control Commission,0,0,0,8,9,26,43
2023-07,0860 - State Board of Equalization,2,1,10,119,5,19,156
2023-07,0870 - Office of Tax Appeals,0,4,7,42,16,25,94
2023-07,0911 - Citizens Redistricting Commission,0,0,0,0,0,1,1
2023-07,1045 - Cannabis Control Appeals Panel,1,0,1,0,1,5,8
2023-07,1111 - Department of Consumer Affairs,222,318,491,411,573,531,2546
2023-07,1115 - Department of Cannabis Control,0,83,19,47,41,234,424
2023-07,1700 - California Civil Rights Department,4,1,3,18,36,202,264
2023-07,1701 - Department of Financial Protection and Innovation,6,11,45,23,61,604,750
2023-07,1703 - California Privacy Protection Agency,0,0,0,1,0,23,24
2023-07,1750 - California Horse Racing Board,1,5,0,6,2,11,25
2023-07,2100 - Department of Alcoholic Beverage Control,94,146,88,55,32,56,471
2023-07,2120 - Alcoholic Beverage Control Appeals Board,0,0,1,3,0,2,6
2023-07,2240 - Department of Housing and Community Development,106,24,66,86,104,730,1116
2023-07,2320 - Department of Real Estate,9,21,29,133,106,26,324
2023-07,2600 - California Transportation Commission,0,1,1,6,4,26,38
2023-07,2660 - Department of Transportation,39,445,1242,7079,2262,2270,13337
2023-07,2665 - High-Speed Rail Authority,3,26,35,48,56,190,358
2023-07,2700 - California Traffic Safety Program,0,0,1,10,21,2,34
2023-07,2720 - California Highway Patrol,1020,0,333,15,64,0,1432
2023-07,2740 - Department of Motor Vehicles,1,146,468,532,412,1035,2594
2023-07,3100 - Exposition Park,0,0,4,4,0,1,9
2023-07,3125 - California Tahoe Conservancy,6,1,11,6,4,18,46
2023-07,3340 - California Conservation Corps,4,14,31,49,25,30,153
2023-07,3355 - Office of Energy Infrastructure Safety,0,0,0,0,0,82,82
2023-07,3360 - Energy Resources Conservation and Development Commission,0,6,9,30,50,628,723
2023-07,3480 - Department of Conservation,33,12,60,94,69,412,680
2023-07,3540 - Department of Forestry and Fire Protection,4,69,174,172,152,206,777
2023-07,3560 - State Lands Commission,35,10,14,20,16,90,185
2023-07,3600 - Department of Fish and Wildlife,406,101,280,313,905,54,2059
2023-07,3640 - Wildlife Conservation Board,11,0,2,7,4,18,42
2023-07,3720 - California Coastal Commission,2,7,10,44,74,48,185
2023-07,3760 - State Coastal Conservancy,0,0,2,2,19,43,66
2023-07,3780 - Native American Heritage Commission,0,1,2,4,1,0,8
2023-07,3790 - Department of Parks and Recreation,729,50,142,205,217,219,1562
2023-07,3810 - Santa Monica Mountains Conservancy,0,0,0,3,0,3,6
2023-07,3820 - San Francisco Bay Conservation and Development Commission,0,0,1,3,50,0,54
2023-07,3825 - San Gabriel and Lower Los Angeles Rivers and Mountains Conservancy,0,0,1,1,7,0,9
2023-07,3830 - San Joaquin River Conservancy,0,0,0,0,1,1,2
2023-07,3835 - Baldwin Hills Conservancy,0,0,1,2,0,0,3
2023-07,3840 - Delta Protection Commission,1,1,0,1,1,2,6
2023-07,3845 - San Diego River Conservancy,3,0,0,0,0,0,3
2023-07,3850 - Coachella Valley Mountains Conservancy,0,1,1,1,0,0,3
2023-07,3855 - Sierra Nevada Conservancy,0,2,5,16,10,18,51
2023-07,3860 - Department of Water Resources,3,114,572,1087,383,129,2288
2023-07,3862 - Central Valley Flood Protection Board,0,6,1,7,16,18,48
2023-07,3875 - Sacramento-San Joaquin Delta Conservancy,0,0,0,1,9,8,18
2023-07,3885 - Delta Stewardship Council,0,1,4,7,10,41,63
2023-07,3900 - State Air Resources Board,172,264,138,150,851,106,1681
2023-07,3930 - Department of Pesticide Regulation,8,8,62,77,85,189,429
2023-07,3940 - State Water Resources Control Board,57,59,325,341,560,998,2340
2023-07,3960 - Department of Toxic Substances Control,8,25,123,67,134,684,1041
2023-07,3970 - Department of Resources Recycling and Recovery,3,17,25,40,98,370,553
2023-07,3980 - Office of Environmental Health Hazard Assessment,0,2,5,12,41,68,128
2023-07,4100 - State Council on Developmental Disabilities,3,7,5,16,5,29,65
2023-07,4140 - Department of Health Care Access and Information,74,8,109,31,42,285,549
2023-07,4150 - Department of Managed Health Care,0,0,0,6,5,546,557
2023-07,4170 - Department of Aging,1,0,8,19,25,208,261
2023-07,4250 - California Children and Families Commission,0,0,0,1,32,0,33
2023-07,4260 - State Department of Health Care Services,583,34,140,279,1143,2067,4246
2023-07,4265 - Department of Public Health,1126,2,83,112,137,2454,3914
2023-07,4300 - Department of Developmental Services,7,11,34,48,101,447,648
2023-07,4440 - Department of State Hospitals,0,676,185,149,235,474,1719
2023-07,4560 - Mental Health Services Oversight and Accountability Commission,5,3,7,13,11,8,47
2023-07,4700 - Department of Community Services and Development,0,0,2,8,11,99,120
2023-07,4800 - California Health Benefit Exchange,21,1,28,50,55,1152,1307
2023-07,5160 - Department of Rehabilitation,132,128,411,495,227,240,1633
2023-07,5170 - State Independent Living Council,0,0,0,0,0,3,3
2023-07,5175 - Department of Child Support Services,4,8,8,13,115,435,583
2023-07,5180 - Department of Social Services,5,401,1374,366,610,1779,4535
2023-07,5225 - Department of Corrections and Rehabilitation,849,462,743,563,426,1663,4706
2023-07,5227 - Board of State and Community Corrections,11,1,0,11,85,11,119
2023-07,5420 - Prison Industry Authority,21,8,113,46,25,20,233
2023-07,6100 - Department of Education,202,18,22,95,95,952,1384
2023-07,6120 - California State Library,3,22,31,15,19,73,163
2023-07,6125 - Education Audit Appeals Panel,0,0,0,1,2,0,3
2023-07,6200 - California School for the Blind,17,3,1,1,0,0,22
2023-07,6240 - California School for the Deaf - Fremont,0,0,0,0,0,4,4
2023-07,6250 - California School for the Deaf - Riverside,5,3,5,2,2,0,17
2023-07,6260 - Diagnostic Centers,22,1,3,0,0,0,26
2023-07,6360 - Commission on Teacher Credentialing,29,7,22,22,86,20,186
2023-07,6870 - Board of Governors of the California Community Colleges,0,0,1,4,3,187,195
2023-07,"6980 - Student Aid Commission, California",1,2,1,10,21,100,135
2023-07,7100 - Employment Development Department,47,255,430,802,744,5223,7501
2023-07,7300 - Agricultural Labor Relations Board,8,0,5,35,5,5,58
2023-07,7320 - Public Employment Relations Board,2,3,4,20,24,11,64
2023-07,7501 - Department of Human Resources,6,7,22,81,56,165,337
2023-07,7502 - California Department of Technology,66,32,8,45,490,329,970
2023-07,7503 - State Personnel Board,2,0,0,3,12,53,70
2023-07,7504 - Office of Data and Innovation,0,0,0,4,4,40,48
2023-07,7600 - California Department of Tax and Fee Administration,21,32,77,479,1462,1548,3619
2023-07,7730 - Franchise Tax Board,454,126,907,3415,195,166,5263
2023-07,7760 - Department of General Services,360,30,324,247,228,900,2089
2023-07,7870 - California Victim Compensation Board,2,0,11,13,199,0,225
2023-07,7900 - Public Employees' Retirement System,77,26,1921,10,4,274,2312
2023-07,7910 - Office of Administrative Law,0,2,7,6,7,2,24
2023-07,7920 - State Teachers' Retirement System,1,4,119,1110,45,2,1281
2023-07,8120 - Commission on Peace Officer Standards and Training,5,6,160,0,0,12,183
2023-07,8140 - State Public Defender,5,4,16,15,10,45,95
2023-07,8570 - Department of Food and Agriculture,93,35,61,82,122,150,543
2023-07,8620 - Fair Political Practices Commission,1,0,2,12,16,60,91
2023-07,8660 - Public Utilities Commission,101,6,72,45,95,1100,1419
2023-07,"8780 - Milton Marks ""Little Hoover"" Commission on California State Government Organization and Economy",0,0,0,2,4,0,6
2023-07,"8830 - Law Revision Commission, California",0,0,0,0,0,8,8
2023-07,8860 - Department of Finance,7,7,30,286,26,42,398
2023-07,8880 - Financial Information System for California,1,0,0,24,6,297,328
2023-07,"8885 - States Mandates, Commission on",0,1,1,1,2,9,14
2023-07,8940 - Military Department,0,8,28,59,11,4,110
2023-07,8955 - Department of Veterans Affairs,36,23,56,141,81,123,460
2023-07,A059 - California Correctional Health Care Services,37,658,537,532,344,974,3082
2023-07,A279 - Unemployment Insurance Appeals Board,160,23,27,77,59,61,407
2023-07,A281 - Employment Training Panel,0,9,12,10,38,5,74
2023-07,A314 - California Science Center,7,4,22,0,0,3,36
2023-07,A341 - California Earthquake Authority,0,1,2,8,6,53,70
2023-07,A424 - Cradle-to-Career,0,0,0,6,0,8,14
2023-07,A541 - Board of Forestry and Fire Protection,0,1,0,3,4,2,10
2023-08,0500 - Governor's Office,32,9,33,42,11,11,138
2023-08,0509 - Governor's Office of Business and Economic Development (GO-Biz),2,3,12,17,15,108,157
2023-08,0511 - Secretary for Government Operations Agency,0,0,13,14,0,0,27
2023-08,0521 - Secretary for Transportation Agency,0,0,3,16,0,1,20
2023-08,0530 - Secretary for California Health and Human Services Agency,1,2,10,6,11,63,93
2023-08,0531 - Office of Systems Integration,5,2,1,10,19,350,387
2023-08,0540 - Secretary of the Natural Resources Agency,1,2,2,19,0,71,95
2023-08,0552 - Office of the Inspector General,8,2,5,8,4,128,155
2023-08,0555 - Secretary for Environmental Protection,36,2,2,3,6,42,91
2023-08,0559 - Secretary for Labor and Workforce Development Agency,5,6,11,7,3,4,36
2023-08,0650 - Office of Planning and Research,2,0,15,25,41,129,212
2023-08,0690 - Governor's Office of Emergency Services,0,99,675,55,27,103,959
2023-08,0820 - Department of Justice,504,280,475,561,564,1634,4018
2023-08,0840 - State Controller,47,35,86,143,163,738,1212
2023-08,0845 - Department of Insurance,3,181,32,66,196,579,1057
2023-08,0855 - California Gambling Control Commission,0,0,0,8,9,26,43
2023-08,0860 - State Board of Equalization,2,1,10,120,5,20,158
2023-08,0870 - Office of Tax Appeals,0,4,7,41,16,25,93
2023-08,0911 - Citizens Redistricting Commission,0,0,0,0,0,1,1
2023-08,1045 - Cannabis Control Appeals Panel,1,0,1,0,1,5,8
2023-08,1111 - Department of Consumer Affairs,205,191,437,495,535,483,2346
2023-08,1115 - Department of Cannabis Control,0,90,17,52,42,227,428
2023-08,1700 - California Civil Rights Department,4,1,4,19,39,208,275
2023-08,1701 - Department of Financial Protection and Innovation,7,11,44,23,61,603,749
2023-08,1703 - California Privacy Protection Agency,0,0,0,1,0,23,24
2023-08,1750 - California Horse Racing Board,1,5,0,6,2,11,25
2023-08,2100 - Department of Alcoholic Beverage Control,95,144,88,55,31,55,468
2023-08,2120 - Alcoholic Beverage Control Appeals Board,0,0,1,3,0,2,6
2023-08,2240 - Department of Housing and Community Development,107,27,65,83,103,732,1117
2023-08,2320 - Department of Real Estate,10,22,25,130,108,28,323
2023-08,2600 - California Transportation Commission,0,1,1,6,4,26,38
2023-08,2660 - Department of Transportation,0,445,1242,7080,2263,2270,13300
2023-08,2665 - High-Speed Rail Authority,6,26,36,49,64,178,359
2023-08,2700 - California Traffic Safety Program,0,0,1,10,21,2,34
2023-08,2720 - California Highway Patrol,1197,0,221,56,7,0,1481
2023-08,2740 - Department of Motor Vehicles,0,148,473,523,416,1046,2606
2023-08,3100 - Exposition Park,0,0,4,4,0,1,9
2023-08,3125 - California Tahoe Conservancy,4,2,11,5,3,16,41
2023-08,3340 - California Conservation Corps,6,14,30,49,24,31,154
2023-08,3355 - Office of Energy Infrastructure Safety,0,0,0,0,0,83,83
2023-08,3360 - Energy Resources Conservation and Development Commission,0,6,10,33,53,643,745
2023-08,3480 - Department of Conservation,33,11,60,98,70,412,684
2023-08,3540 - Department of Forestry and Fire Protection,5,73,181,176,153,210,798
2023-08,3560 - State Lands Commission,35,9,14,20,17,91,186
2023-08,3600 - Department of Fish and Wildlife,395,100,286,321,910,45,2057
2023-08,3640 - Wildlife Conservation Board,11,0,2,8,4,17,42
2023-08,3720 - California Coastal Commission,2,7,13,45,74,48,189
2023-08,3760 - State Coastal Conservancy,0,0,2,3,62,0,67
2023-08,3780 - Native American Heritage Commission,0,1,2,4,1,0,8
2023-08,3790 - Department of Parks and Recreation,743,56,160,240,227,227,1653
2023-08,3810 - Santa Monica Mountains Conservancy,0,0,0,3,0,3,6
2023-08,3820 - San Francisco Bay Conservation and Development Commission,0,0,1,3,49,0,53
2023-08,3825 - San Gabriel and Lower Los Angeles Rivers and Mountains Conservancy,0,1,1,2,6,0,10
2023-08,3830 - San Joaquin River Conservancy,0,0,0,0,1,1,2
2023-08,3835 - Baldwin Hills Conservancy,0,0,1,2,0,0,3
2023-08,3840 - Delta Protection Commission,1,1,0,1,1,2,6
2023-08,3845 - San Diego River Conservancy,3,0,0,0,0,0,3
2023-08,3850 - Coachella Valley Mountains Conservancy,0,1,1,1,0,0,3
2023-08,3855 - Sierra Nevada Conservancy,0,2,5,16,9,19,51
2023-08,3860 - Department of Water Resources,4,120,572,1089,395,140,2320
2023-08,3862 - Central Valley Flood Protection Board,0,6,1,7,16,18,48
2023-08,3875 - Sacramento-San Joaquin Delta Conservancy,0,0,1,1,3,13,18
2023-08,3885 - Delta Stewardship Council,0,1,3,11,11,38,64
2023-08,3900 - State Air Resources Board,183,264,136,150,855,116,1704
2023-08,3930 - Department of Pesticide Regulation,8,10,63,79,85,188,433
2023-08,3940 - State Water Resources Control Board,55,57,327,342,553,1010,2344
2023-08,3980 - Office of Environmental Health Hazard Assessment,0,2,5,12,41,68,128
2023-08,4100 - State Council on Developmental Disabilities,3,7,5,16,5,29,65
2023-08,4140 - Department of Health Care Access and Information,77,9,108,30,42,287,553
2023-08,4150 - Department of Managed Health Care,0,0,0,3,5,537,545
2023-08,4170 - Department of Aging,1,0,9,20,25,208,263
2023-08,4250 - California Children and Families Commission,0,0,0,1,32,0,33
2023-08,4260 - State Department of Health Care Services,1058,25,130,211,998,1842,4264
2023-08,4265 - Department of Public Health,1126,2,83,112,137,2454,3914
2023-08,4300 - Department of Developmental Services,8,14,30,52,103,457,664
2023-08,4440 - Department of State Hospitals,2,768,186,151,243,487,1837
2023-08,4560 - Mental Health Services Oversight and Accountability Commission,6,3,8,14,12,6,49
2023-08,4700 - Department of Community Services and Development,0,0,2,8,11,99,120
2023-08,4800 - California Health Benefit Exchange,21,1,29,49,56,1182,1338
2023-08,5160 - Department of Rehabilitation,125,127,412,487,220,241,1612
2023-08,5170 - State Independent Living Council,0,0,0,0,0,3,3
2023-08,5175 - Department of Child Support Services,6,8,7,13,116,443,593
2023-08,5180 - Department of Social Services,5,400,1361,369,609,1771,4515
2023-08,5225 - Department of Corrections and Rehabilitation,921,448,720,544,405,1622,4660
2023-08,5227 - Board of State and Community Corrections,11,1,0,11,84,9,116
2023-08,5420 - Prison Industry Authority,17,8,115,46,22,17,225
2023-08,6100 - Department of Education,214,19,22,94,96,954,1399
2023-08,6120 - California State Library,2,21,31,14,18,72,158
2023-08,6125 - Education Audit Appeals Panel,0,0,0,1,2,0,3
2023-08,6200 - California School for the Blind,17,3,1,1,0,0,22
2023-08,6240 - California School for the Deaf - Fremont,0,0,0,0,0,4,4
2023-08,6250 - California School for the Deaf - Riverside,5,3,5,2,2,0,17
2023-08,6260 - Diagnostic Centers,22,1,3,0,0,0,26
2023-08,6360 - Commission on Teacher Credentialing,25,7,22,21,88,22,185
2023-08,"6980 - Student Aid Commission, California",1,2,1,10,21,100,135
2023-08,7100 - Employment Development Department,46,251,431,795,740,5122,7385
2023-08,7300 - Agricultural Labor Relations Board,8,0,5,36,5,5,59
2023-08,7320 - Public Employment Relations Board,1,3,4,20,24,11,63
2023-08,7501 - Department of Human Resources,8,7,20,84,57,157,333
2023-08,7502 - California Department of Technology,68,31,8,44,494,324,969
2023-08,7503 - State Personnel Board,2,0,0,6,10,51,69
2023-08,7504 - Office of Data and Innovation,0,0,0,4,4,43,51
2023-08,7600 - California Department of Tax and Fee Administration,32,29,75,486,1463,1538,3623
2023-08,7730 - Franchise Tax Board,478,117,1099,3416,130,174,5414
2023-08,7760 - Department of General Services,322,28,330,258,222,879,2039
2023-08,7870 - California Victim Compensation Board,2,0,11,13,202,0,228
2023-08,7900 - Public Employees' Retirement System,78,27,1997,7,4,281,2394
2023-08,7910 - Office of Administrative Law,0,2,7,6,7,2,24
2023-08,7920 - State Teachers' Retirement System,3,5,121,1117,45,1,1292
2023-08,8120 - Commission on Peace Officer Standards and Training,5,5,160,0,0,12,182
2023-08,8140 - State Public Defender,4,4,16,15,10,43,92
2023-08,8570 - Department of Food and Agriculture,107,37,63,93,126,180,606
2023-08,8620 - Fair Political Practices Commission,1,0,2,13,15,64,95
2023-08,8660 - Public Utilities Commission,99,6,71,45,94,1100,1415
2023-08,"8780 - Milton Marks ""Little Hoover"" Commission on California State Government Organization and Economy",0,0,0,2,4,0,6
2023-08,"8830 - Law Revision Commission, California",0,0,0,0,0,8,8
2023-08,8860 - Department of Finance,7,8,30,281,25,41,392
2023-08,8880 - Financial Information System for California,1,0,1,22,6,298,328
2023-08,"8885 - States Mandates, Commission on",0,1,1,1,3,9,15
2023-08,8940 - Military Department,0,9,26,59,11,5,110
2023-08,8955 - Department of Veterans Affairs,36,23,56,141,81,123,460
2023-08,A059 - California Correctional Health Care Services,1,696,540,556,357,991,3141
2023-08,A279 - Unemployment Insurance Appeals Board,161,23,28,75,59,60,406
2023-08,A281 - Employment Training Panel,0,9,12,10,38,5,74
2023-08,A314 - California Science Center,7,4,22,0,0,3,36
2023-08,A341 - California Earthquake Authority,0,1,2,8,6,53,70
2023-08,A424 - Cradle-to-Career,0,0,0,6,0,9,15
2023-08,A541 - Board of Forestry and Fire Protection,0,1,0,3,4,2,10
2023-09,0500 - Governor's Office,35,9,34,42,11,11,142
2023-09,0509 - Governor's Office of Business and Economic Development (GO-Biz),3,3,14,16,17,109,162
2023-09,0511 - Secretary for Government Operations Agency,0,0,13,14,0,0,27
2023-09,0521 - Secretary for Transportation Agency,0,0,3,16,0,1,20
2023-09,0530 - Secretary for California Health and Human Services Agency,1,2,10,6,11,67,97
2023-09,0531 - Office of Systems Integration,5,3,1,10,19,351,389
2023-09,0540 - Secretary of the Natural Resources Agency,1,1,3,20,1,73,99
2023-09,0552 - Office of the Inspector General,8,2,6,6,5,133,160
2023-09,0559 - Secretary for Labor and Workforce Development Agency,5,6,11,7,3,4,36
2023-09,0650 - Office of Planning and Research,2,0,15,25,38,126,206
2023-09,0690 - Governor's Office of Emergency Services,0,99,689,50,26,98,962
2023-09,0820 - Department of Justice,406,313,583,502,575,1616,3995
2023-09,0840 - State Controller,44,34,91,147,190,710,1216
2023-09,0845 - Department of Insurance,9,175,29,66,202,575,1056
2023-09,0855 - California Gambling Control Commission,2,1,0,8,11,21,43
2023-09,0860 - State Board of Equalization,2,1,10,120,6,20,159
2023-09,0870 - Office of Tax Appeals,0,4,8,42,16,27,97
2023-09,0911 - Citizens Redistricting Commission,0,0,0,0,0,1,1
2023-09,1045 - Cannabis Control Appeals Panel,1,0,1,0,1,5,8
2023-09,1111 - Department of Consumer Affairs,205,191,437,495,535,483,2346
2023-09,1115 - Department of Cannabis Control,0,89,20,48,40,229,426
2023-09,1700 - California Civil Rights Department,3,1,4,19,36,207,270
2023-09,1701 - Department of Financial Protection and Innovation,6,11,47,25,59,604,752
2023-09,1703 - California Privacy Protection Agency,0,0,0,1,0,24,25
2023-09,1750 - California Horse Racing Board,1,5,0,6,2,11,25
2023-09,2100 - Department of Alcoholic Beverage Control,95,143,87,55,31,58,469
2023-09,2240 - Department of Housing and Community Development,104,28,59,88,110,740,1129
2023-09,2320 - Department of Real Estate,10,22,21,131,107,28,319
2023-09,2600 - California Transportation Commission,0,1,0,6,4,27,38
2023-09,2660 - Department of Transportation,0,445,1241,7079,2262,2270,13297
2023-09,2665 - High-Speed Rail Authority,7,27,38,48,65,184,369
2023-09,2700 - California Traffic Safety Program,0,0,1,10,22,2,35
2023-09,2720 - California Highway Patrol,1170,0,228,58,7,0,1463
2023-09,2740 - Department of Motor Vehicles,0,151,467,537,408,1035,2598
2023-09,3100 - Exposition Park,0,0,4,4,0,1,9
2023-09,3125 - California Tahoe Conservancy,4,2,11,5,3,16,41
2023-09,3340 - California Conservation Corps,5,14,29,50,23,31,152
2023-09,3355 - Office of Energy Infrastructure Safety,0,0,0,0,0,82,82
2023-09,3360 - Energy Resources Conservation and Development Commission,0,7,10,34,55,654,760
2023-09,3480 - Department of Conservation,35,13,61,102,72,416,699
2023-09,3540 - Department of Forestry and Fire Protection,5,75,184,179,157,211,811
2023-09,3560 - State Lands Commission,30,15,10,27,27,80,189
2023-09,3600 - Department of Fish and Wildlife,417,83,277,316,941,32,2066
2023-09,3640 - Wildlife Conservation Board,12,0,2,7,6,16,43
2023-09,3720 - California Coastal Commission,2,7,13,45,74,48,189
2023-09,3760 - State Coastal Conservancy,0,0,2,3,62,0,67
2023-09,3780 - Native American Heritage Commission,0,1,2,4,1,0,8
2023-09,3790 - Department of Parks and Recreation,738,60,153,243,234,222,1650
2023-09,3810 - Santa Monica Mountains Conservancy,0,0,0,5,0,1,6
2023-09,3820 - San Francisco Bay Conservation and Development Commission,0,0,1,4,48,0,53
2023-09,3825 - San Gabriel and Lower Los Angeles Rivers and Mountains Conservancy,1,1,1,1,6,0,10
2023-09,3830 - San Joaquin River Conservancy,0,0,0,0,1,1,2
2023-09,3835 - Baldwin Hills Conservancy,0,0,1,2,0,0,3
2023-09,3840 - Delta Protection Commission,1,1,0,1,1,2,6
2023-09,3845 - San Diego River Conservancy,3,0,0,0,0,0,3
2023-09,3850 - Coachella Valley Mountains Conservancy,0,1,1,1,0,0,3
2023-09,3855 - Sierra Nevada Conservancy,0,2,5,16,9,19,51
2023-09,3860 - Department of Water Resources,2,105,558,1086,405,95,2251
2023-09,3862 - Central Valley Flood Protection Board,0,6,1,8,16,17,48
2023-09,3875 - Sacramento-San Joaquin Delta Conservancy,0,0,1,0,3,12,16
2023-09,3885 - Delta Stewardship Council,0,1,4,7,10,43,65
2023-09,3900 - State Air Resources Board,183,264,136,150,855,116,1704
2023-09,3930 - Department of Pesticide Regulation,7,10,64,81,83,190,435
2023-09,3940 - State Water Resources Control Board,54,73,321,417,588,1085,2538
2023-09,3960 - Department of Toxic Substances Control,8,31,126,66,135,701,1067
2023-09,3970 - Department of Resources Recycling and Recovery,0,10,30,34,99,414,587
2023-09,3980 - Office of Environmental Health Hazard Assessment,0,2,5,12,41,68,128
2023-09,4100 - State Council on Developmental Disabilities,3,7,5,16,5,29,65
2023-09,4140 - Department of Health Care Access and Information,77,10,110,29,40,287,553
2023-09,4150 - Department of Managed Health Care,0,0,0,3,5,531,539
2023-09,4170 - Department of Aging,1,0,8,22,23,212,266
2023-09,4250 - California Children and Families Commission,0,0,0,1,32,0,33
2023-09,4260 - State Department of Health Care Services,654,30,143,245,1116,2123,4311
2023-09,4265 - Department of Public Health,1126,2,83,112,137,2454,3914
2023-09,4300 - Department of Developmental Services,6,12,39,50,100,462,669
2023-09,4440 - Department of State Hospitals,1,749,183,154,243,489,1819
2023-09,4560 - Mental Health Services Oversight and Accountability Commission,6,3,8,14,12,6,49
2023-09,4700 - Department of Community Services and Development,0,0,2,8,11,100,121
2023-09,4800 - California Health Benefit Exchange,21,1,29,49,55,1183,1338
2023-09,5160 - Department of Rehabilitation,132,127,409,487,220,240,1615
2023-09,5170 - State Independent Living Council,0,0,0,0,0,3,3
2023-09,5175 - Department of Child Support Services,3,7,7,13,122,446,598
2023-09,5180 - Department of Social Services,3,395,1384,372,623,1806,4583
2023-09,5225 - Department of Corrections and Rehabilitation,928,446,714,540,386,1480,4494
2023-09,5227 - Board of State and Community Corrections,11,1,0,11,83,9,115
2023-09,5420 - Prison Industry Authority,17,9,113,48,20,20,227
2023-09,6100 - Department of Education,159,17,28,102,106,988,1400
2023-09,6120 - California State Library,3,21,31,14,18,72,159
2023-09,6125 - Education Audit Appeals Panel,0,0,0,1,2,0,3
2023-09,6200 - California School for the Blind,17,3,1,1,0,0,22
2023-09,6240 - California School for the Deaf - Fremont,0,0,0,0,0,4,4
2023-09,6250 - California School for the Deaf - Riverside,5,3,5,2,2,0,17
2023-09,6260 - Diagnostic Centers,22,1,3,0,0,0,26
2023-09,6360 - Commission on Teacher Credentialing,21,6,22,22,83,22,176
2023-09,6870 - Board of Governors of the California Community Colleges,0,0,0,4,2,193,199
2023-09,7100 - Employment Development Department,46,255,437,796,746,5138,7418
2023-09,7300 - Agricultural Labor Relations Board,8,0,5,37,5,5,60
2023-09,7320 - Public Employment Relations Board,1,3,4,20,24,11,63
2023-09,7501 - Department of Human Resources,9,8,20,83,59,154,333
2023-09,7502 - California Department of Technology,68,35,8,40,500,320,971
2023-09,7503 - State Personnel Board,1,0,0,4,16,48,69
2023-09,7504 - Office of Data and Innovation,0,0,0,4,5,43,52
2023-09,7600 - California Department of Tax and Fee Administration,32,27,75,487,1463,1519,3603
2023-09,7730 - Franchise Tax Board,516,112,1216,3444,101,188,5577
2023-09,7760 - Department of General Services,331,29,331,239,244,916,2090
2023-09,7870 - California Victim Compensation Board,1,0,17,15,202,0,235
2023-09,7900 - Public Employees' Retirement System,79,30,1994,8,4,276,2391
2023-09,7910 - Office of Administrative Law,0,2,10,4,6,2,24
2023-09,7920 - State Teachers' Retirement System,4,3,117,1114,47,1,1286
2023-09,8120 - Commission on Peace Officer Standards and Training,4,6,158,0,0,12,180
2023-09,8140 - State Public Defender,3,4,14,14,10,44,89
2023-09,8570 - Department of Food and Agriculture,82,29,61,77,114,146,509
2023-09,8620 - Fair Political Practices Commission,2,0,2,13,16,64,97
2023-09,8660 - Public Utilities Commission,99,6,71,45,94,1138,1453
2023-09,"8780 - Milton Marks ""Little Hoover"" Commission on California State Government Organization and Economy",0,0,0,2,4,0,6
2023-09,"8830 - Law Revision Commission, California",0,0,0,0,0,8,8
2023-09,8860 - Department of Finance,7,8,30,283,25,43,396
2023-09,8880 - Financial Information System for California,0,1,0,20,36,269,326
2023-09,"8885 - States Mandates, Commission on",0,1,1,1,3,9,15
2023-09,8940 - Military Department,1,10,23,55,12,4,105
2023-09,8955 - Department of Veterans Affairs,34,23,58,140,83,123,461
2023-09,A059 - California Correctional Health Care Services,0,686,540,545,358,1013,3142
2023-09,A279 - Unemployment Insurance Appeals Board,159,23,29,76,57,60,404
2023-09,A281 - Employment Training Panel,0,9,12,10,38,5,74
2023-09,A314 - California Science Center,5,5,20,0,0,3,33
2023-09,A341 - California Earthquake Authority,0,1,2,8,6,53,70
2023-09,A424 - Cradle-to-Career,0,0,0,7,1,9,17
2023-09,A541 - Board of Forestry and Fire Protection,0,1,0,3,4,2,10
2023-10,0500 - Governor's Office,33,9,34,44,11,13,144
2023-10,0509 - Governor's Office of Business and Economic Development (GO-Biz),1,3,14,17,15,105,155
2023-10,0511 - Secretary for Government Operations Agency,0,0,13,16,0,0,29
2023-10,"0515 - Secretary for Business, Consumer Services, and Housing Agency",1,2,3,10,6,47,69
2023-10,0521 - Secretary for Transportation Agency,0,0,3,16,0,1,20
2023-10,0530 - Secretary for California Health and Human Services Agency,1,2,10,6,11,72,102
2023-10,0531 - Office of Systems Integration,6,3,1,9,18,353,390
2023-10,0540 - Secretary of the Natural Resources Agency,1,1,3,20,1,74,100
2023-10,0552 - Office of the Inspector General,9,2,6,6,6,137,166
2023-10,0559 - Secretary for Labor and Workforce Development Agency,5,6,11,7,3,4,36
2023-10,0650 - Office of Planning and Research,2,0,15,24,38,124,203
2023-10,0690 - Governor's Office of Emergency Services,0,99,691,50,27,99,966
2023-10,0820 - Department of Justice,425,295,539,587,580,1679,4105
2023-10,0840 - State Controller,41,30,79,148,188,716,1202
2023-10,0845 - Department of Insurance,6,174,26,69,197,579,1051
2023-10,0855 - California Gambling Control Commission,2,1,0,8,11,21,43
2023-10,0860 - State Board of Equalization,2,1,10,121,6,21,161
2023-10,0870 - Office of Tax Appeals,0,4,7,42,16,27,96
2023-10,1045 - Cannabis Control Appeals Panel,1,0,1,0,1,5,8
2023-10,1111 - Department of Consumer Affairs,213,195,500,490,587,408,2393
2023-10,1115 - Department of Cannabis Control,0,92,20,53,40,231,436
2023-10,1700 - California Civil Rights Department,3,1,4,19,36,207,270
2023-10,1701 - Department of Financial Protection and Innovation,6,12,48,26,59,599,750
2023-10,1703 - California Privacy Protection Agency,0,0,0,1,0,26,27
2023-10,1750 - California Horse Racing Board,1,5,0,7,2,11,26
2023-10,2100 - Department of Alcoholic Beverage Control,91,142,89,55,31,60,468
2023-10,2120 - Alcoholic Beverage Control Appeals Board,0,0,1,3,0,2,6
2023-10,2240 - Department of Housing and Community Development,105,30,59,83,117,748,1142
2023-10,2320 - Department of Real Estate,10,22,21,132,107,27,319
2023-10,2600 - California Transportation Commission,0,1,0,6,4,27,38
2023-10,2660 - Department of Transportation,0,445,1241,7074,2262,2270,13292
2023-10,2665 - High-Speed Rail Authority,1,28,38,48,65,190,370
2023-10,2700 - California Traffic Safety Program,0,0,1,10,22,2,35
2023-10,2720 - California Highway Patrol,1168,0,229,60,6,0,1463
2023-10,2740 - Department of Motor Vehicles,0,160,462,544,409,1042,2617
2023-10,3100 - Exposition Park,0,0,4,3,0,1,8
2023-10,3125 - California Tahoe Conservancy,4,2,11,5,3,16,41
2023-10,3355 - Office of Energy Infrastructure Safety,0,0,0,0,0,62,62
2023-10,3360 - Energy Resources Conservation and Development Commission,0,7,10,33,55,667,772
2023-10,3480 - Department of Conservation,33,12,63,108,72,418,706
2023-10,3540 - Department of Forestry and Fire Protection,5,85,192,200,165,217,864
2023-10,3560 - State Lands Commission,33,14,11,28,28,81,195
2023-10,3600 - Department of Fish and Wildlife,392,85,285,322,941,28,2053
2023-10,3640 - Wildlife Conservation Board,11,0,2,8,6,16,43
2023-10,3720 - California Coastal Commission,1,8,12,130,25,19,195
2023-10,3760 - State Coastal Conservancy,0,0,1,66,0,0,67
2023-10,3780 - Native American Heritage Commission,0,1,2,4,1,0,8
2023-10,3790 - Department of Parks and Recreation,730,61,169,257,234,229,1680
2023-10,3810 - Santa Monica Mountains Conservancy,0,0,0,5,0,1,6
2023-10,3820 - San Francisco Bay Conservation and Development Commission,0,0,1,5,48,0,54
2023-10,3825 - San Gabriel and Lower Los Angeles Rivers and Mountains Conservancy,1,1,1,1,6,0,10
2023-10,3830 - San Joaquin River Conservancy,1,0,0,0,1,2,4
2023-10,3835 - Baldwin Hills Conservancy,0,0,1,2,0,0,3
2023-10,3840 - Delta Protection Commission,1,0,0,1,1,2,5
2023-10,3845 - San Diego River Conservancy,3,0,0,0,0,0,3
2023-10,3850 - Coachella Valley Mountains Conservancy,0,1,1,1,0,0,3
2023-10,3855 - Sierra Nevada Conservancy,0,2,5,16,9,19,51
2023-10,3860 - Department of Water Resources,2,120,554,1114,430,95,2315
2023-10,3862 - Central Valley Flood Protection Board,0,5,1,8,15,16,45
2023-10,3875 - Sacramento-San Joaquin Delta Conservancy,0,0,1,1,7,7,16
2023-10,3885 - Delta Stewardship Council,0,1,4,8,10,43,66
2023-10,3930 - Department of Pesticide Regulation,7,9,66,78,79,188,427
2023-10,3940 - State Water Resources Control Board,77,83,339,447,617,1157,2720
2023-10,3960 - Department of Toxic Substances Control,8,31,127,67,140,705,1078
2023-10,3970 - Department of Resources Recycling and Recovery,0,1,18,10,66,105,200
2023-10,3980 - Office of Environmental Health Hazard Assessment,0,2,5,12,41,68,128
2023-10,4140 - Department of Health Care Access and Information,75,10,110,28,42,291,556
2023-10,4150 - Department of Managed Health Care,0,0,0,3,5,568,576
2023-10,4170 - Department of Aging,1,0,9,23,20,214,267
2023-10,4250 - California Children and Families Commission,1,0,0,1,31,0,33
2023-10,4260 - State Department of Health Care Services,617,30,142,259,1128,2172,4348
2023-10,4265 - Department of Public Health,1126,2,83,112,137,2454,3914
2023-10,4300 - Department of Developmental Services,6,13,38,52,105,464,678
2023-10,4440 - Department of State Hospitals,1,805,189,153,244,493,1885
2023-10,4560 - Mental Health Services Oversight and Accountability Commission,6,2,8,14,13,6,49
2023-10,4700 - Department of Community Services and Development,0,0,2,8,11,102,123
2023-10,4800 - California Health Benefit Exchange,22,1,29,49,58,1179,1338
2023-10,5160 - Department of Rehabilitation,131,127,406,491,219,237,1611
2023-10,5170 - State Independent Living Council,0,0,0,0,0,3,3
2023-10,5175 - Department of Child Support Services,3,7,7,13,120,448,598
2023-10,5180 - Department of Social Services,3,394,1356,376,623,1806,4558
2023-10,5225 - Department of Corrections and Rehabilitation,827,456,729,557,414,1628,4611
2023-10,5227 - Board of State and Community Corrections,11,1,0,11,83,9,115
2023-10,5420 - Prison Industry Authority,11,8,119,48,21,19,226
2023-10,6120 - California State Library,3,24,33,14,18,71,163
2023-10,6125 - Education Audit Appeals Panel,0,0,0,1,2,0,3
2023-10,6200 - California School for the Blind,18,2,1,1,0,0,22
2023-10,6240 - California School for the Deaf - Fremont,0,1,0,0,0,4,5
2023-10,6250 - California School for the Deaf - Riverside,5,3,5,2,2,0,17
2023-10,6260 - Diagnostic Centers,22,1,3,0,0,0,26
2023-10,6360 - Commission on Teacher Credentialing,11,5,19,24,85,22,166
2023-10,6870 - Board of Governors of the California Community Colleges,0,0,0,4,2,194,200
2023-10,"6980 - Student Aid Commission, California",0,0,2,21,21,102,146
2023-10,7100 - Employment Development Department,52,254,437,803,751,5100,7397
2023-10,7300 - Agricultural Labor Relations Board,8,0,5,37,5,5,60
2023-10,7320 - Public Employment Relations Board,2,3,5,17,26,10,63
2023-10,7501 - Department of Human Resources,9,6,20,83,62,149,329
2023-10,7502 - California Department of Technology,69,35,7,41,507,313,972
2023-10,7503 - State Personnel Board,1,1,0,4,15,49,70
2023-10,7504 - Office of Data and Innovation,0,0,0,3,5,41,49
2023-10,7600 - California Department of Tax and Fee Administration,33,27,73,498,1480,1514,3625
2023-10,7730 - Franchise Tax Board,571,124,1267,3448,97,200,5707
2023-10,7760 - Department of General Services,340,27,332,231,259,918,2107
2023-10,7870 - California Victim Compensation Board,1,0,17,15,201,0,234
2023-10,7900 - Public Employees' Retirement System,79,28,2009,6,5,287,2414
2023-10,7910 - Office of Administrative Law,0,2,10,4,6,2,24
2023-10,7920 - State Teachers' Retirement System,3,3,120,1139,46,1,1312
2023-10,8120 - Commission on Peace Officer Standards and Training,3,5,163,0,0,12,183
2023-10,8140 - State Public Defender,3,4,14,14,9,45,89
2023-10,8570 - Department of Food and Agriculture,86,42,63,106,111,177,585
2023-10,8620 - Fair Political Practices Commission,2,0,2,13,16,64,97
2023-10,8660 - Public Utilities Commission,24,6,81,47,91,1111,1360
2023-10,"8780 - Milton Marks ""Little Hoover"" Commission on California State Government Organization and Economy",0,0,0,2,4,0,6
2023-10,"8830 - Law Revision Commission, California",0,0,0,0,0,9,9
2023-10,8860 - Department of Finance,7,8,31,291,25,43,405
2023-10,8880 - Financial Information System for California,0,1,0,20,36,268,325
2023-10,"8885 - States Mandates, Commission on",0,1,1,1,3,9,15
2023-10,8940 - Military Department,3,9,23,56,13,5,109
2023-10,8955 - Department of Veterans Affairs,35,22,58,139,80,127,461
2023-10,A059 - California Correctional Health Care Services,2,680,561,547,358,997,3145
2023-10,A279 - Unemployment Insurance Appeals Board,148,24,28,80,57,60,397
2023-10,A281 - Employment Training Panel,0,9,12,10,38,5,74
2023-10,A314 - California Science Center,5,5,20,0,0,3,33
2023-10,A341 - California Earthquake Authority,0,1,2,8,5,58,74
2023-10,A424 - Cradle-to-Career,0,0,2,6,2,9,19
2023-10,A541 - Board of Forestry and Fire Protection,0,1,0,3,4,2,10
